{
  "cmd": "STOP_LIVE_ROOM_LIST",
  "data": {
    "room_id_list": [
      14543461,
      23190973,
      24940790,
      25561135,
      26200636,
      26500934,
      7595061,
      9487155,
      10893094,
      24946259,
      26540599,
      26660421,
      5395688,
      9153583,
      921420,
      189605,
      23095911,
      24076173,
      25407545,
      26391498,
      26646051,
      11102067,
      11727946,
      13487389,
      14328861,
      22698857,
      23579306,
      23620752,
      25926821,
      26232481,
      708225,
      9693884,
      11211522,
      22120924,
      22201715,
      25682914,
      25808010,
      26545971,
      74107,
      14804814,
      21612895,
      21963471,
      22313453,
      22751316,
      24323182,
      25958896,
      6804177,
      8240116,
      22259140,
      23062980,
      23799225,
      25204462,
      26496824,
      26608944,
      21247121,
      24597152,
      25850486,
      2999608,
      8350700,
      22113266,
      22721883,
      24468924,
      26591914,
      26681208,
      4260523,
      8290778,
      2105330,
      23734908,
      26685389,
      330963,
      4194499,
      5933245,
      6051251,
      6206840,
      25907816,
      26690966,
      26691368,
      1111414,
      24019289,
      24970721,
      25664812,
      26091030,
      26272923,
      3592702,
      5385851,
      5400844,
      5875605,
      7367185,
      8612196,
      96392,
      10310907,
      11562378,
      23489012,
      25884639,
      26684119,
      13810566,
      26691298,
      40088,
      4935104,
      6742432,
      1510382,
      22035818,
      6232233,
      7655771,
      786418,
      22398412,
      26314406,
      428614,
      4873610,
      7424613,
      9846025,
      1118646,
      11825517,
      21985561,
      22130418,
      24927164,
      26116016,
      4607832,
      5497013,
      24836007,
      25342730,
      26022578,
      26304861,
      7842203,
      149521,
      21293140,
      25102791,
      26378738,
      26635451,
      5529140,
      24161496,
      25897384,
      26200370,
      26691489,
      323834,
      1076399,
      21674701,
      22315699,
      24019702,
      24465549,
      25220427,
      25901405,
      8501068,
      9637315,
      11746486,
      2094327,
      22607241,
      24048369,
      25562766,
      25923301,
      26677554,
      22206594,
      22322674,
      23139767,
      25011517,
      26595031,
      4664386,
      6433034,
      1067258,
      2091453,
      22473119,
      23814422,
      24702689,
      25810249,
      26424919,
      6171894,
      10351642,
      10411542,
      21470282,
      26408816,
      26445469,
      26680472,
      70334,
      21176045,
      22731702,
      23203462,
      24277054,
      25547509,
      26116249,
      26600862,
      4861649,
      7151227,
      8117967,
      871402,
      10527822,
      24085254,
      2531091,
      26475722,
      26599542,
      6892663,
      1260340,
      13006680,
      1815912,
      21655807,
      23634740,
      23766157,
      25214125,
      26598269,
      2890011,
      8723765,
      903152,
      10604422,
      14700722,
      24851022,
      26244642,
      26375735,
      26566209,
      6457958,
      879243,
      14894699,
      21210136,
      24172305,
      24620974,
      25245742,
      25582402,
      25628661,
      26272707,
      26691145,
      2849485,
      6338570,
      7411097,
      24138621,
      26375039
    ]
  }
}