{
  "cmd": "STOP_LIVE_ROOM_LIST",
  "data": {
    "room_id_list": [
      23121461,
      25937697,
      25544993,
      26127339,
      9315875,
      21589055,
      23036066,
      26679448,
      22012441,
      26693226,
      598457,
      6149485,
      22833756,
      26147856,
      5871561,
      26611374,
      12048989,
      26058809,
      26693605,
      11056105,
      21720487,
      22332130,
      24318075,
      25140640,
      26450320,
      12718116,
      1607626,
      26662576,
      500826,
      7503775,
      8794376,
      12189288,
      24616954,
      25684063,
      26586176,
      8603198,
      9244316,
      23165673,
      25762518,
      26309160,
      26379650,
      26419320,
      26677439,
      26677497,
      1175294,
      13305243,
      22927528,
      24344788,
      25637241,
      23355770,
      26509981,
      22034035,
      24868319,
      25580046,
      25937245,
      26688749,
      5108708,
      5486495,
      612515,
      8559826,
      14145969,
      23183623,
      24059516,
      344093,
      4922449,
      8703564,
      8898707,
      1135227,
      24050809,
      25943705,
      26637377,
      7158629,
      10262119,
      23564733,
      24113758,
      24975817,
      25866929,
      26021531,
      26488759,
      26688602,
      835569,
      22172135,
      23874547,
      24586900,
      25235127,
      26051037,
      26693801,
      4912049,
      8155598,
      23133411,
      24480537,
      25074329,
      25626004,
      26581066,
      284595,
      23329700,
      24375352,
      25420809,
      4501170,
      4590843,
      21968312,
      24209957,
      26142109,
      26562442,
      26583384,
      10149416,
      22185332,
      25781527,
      26526033,
      26583455,
      23436754,
      26693370,
      26112325,
      26663003,
      8103981,
      24702198,
      25798383,
      26559857,
      23305792,
      2443462,
      26593835,
      4492424,
      23656454,
      24049582,
      25628004,
      9123959,
      24335342,
      25755330,
      26672390,
      26188634,
      26367714
    ]
  }
}