{
  "cmd": "STOP_LIVE_ROOM_LIST",
  "data": {
    "room_id_list": [
      11905526,
      2270169,
      23392470,
      492750,
      5255403,
      8813946,
      8949254,
      11960575,
      24041749,
      24969728,
      4045747,
      4490704,
      2252994,
      23190918,
      23824498,
      251150,
      26505476,
      4462201,
      10877000,
      22753606,
      22993417,
      25051620,
      25737932,
      25788579,
      26074357,
      26685948,
      8532760,
      24080520,
      24972962,
      5647214,
      13265797,
      13776710,
      2077907,
      23697758,
      25887133,
      26398711,
      26476948,
      26508408,
      26651678,
      26690783,
      3562997,
      7665614,
      9651348,
      12589412,
      25743651,
      26061392,
      26690875,
      2896459,
      12580593,
      1877536,
      22462684,
      24079624,
      26354055,
      9265074,
      23158020,
      23532051,
      24098033,
      25045332,
      25220016,
      26421771,
      26645145,
      375544,
      868973,
      11572891,
      25286769,
      25864084,
      670900,
      12667021,
      13535715,
      1997996,
      22740185,
      26642885,
      13014945,
      14322760,
      2068931,
      23000174,
      26250768,
      5118003,
      11899129,
      12430380,
      12537267,
      22281029,
      23308320,
      26272445,
      26524314,
      26560161,
      1610235,
      22977400,
      169732,
      22297684,
      24841296,
      24905417,
      26259204,
      26648479,
      26690967,
      22737898,
      25714118,
      26578419,
      26656362,
      26677677,
      26690841,
      12220638,
      23864564,
      23944612,
      24904938,
      25750478,
      26419917,
      26508883,
      1807406,
      26127876,
      2628188,
      26419680,
      26615227,
      4624983,
      702514,
      9331070,
      11691297,
      14407552,
      21855462,
      22498733,
      24800782,
      26233032,
      1154036,
      22462965,
      23668633,
      23793701,
      24291087,
      25256071,
      26677321,
      7001969,
      979521,
      22705389,
      22852537,
      3255119,
      3402651,
      21283409,
      22470017,
      23137228,
      23232950,
      23690247,
      24353846,
      3190287,
      1771732,
      22069036,
      24354909,
      24616543,
      26688324,
      3017226,
      4282319,
      8144169,
      11984055,
      189153,
      24371234,
      24594486,
      2469578,
      25142364,
      25619857,
      26099589,
      26690712,
      26690919,
      9158484,
      21859505,
      2217501,
      24137474,
      25232955,
      26677447,
      26690713,
      8676999,
      22765823,
      2279326,
      26467227,
      26672849,
      4858418,
      5989540,
      804004,
      9164074,
      11288830,
      22298427,
      24597031,
      25988237,
      26373442,
      26586408,
      26690857,
      7529785,
      7546115,
      26388937,
      11353358,
      1846702,
      24014380,
      24055753,
      24274877,
      25731857
    ]
  }
}