{
  "cmd": "STOP_LIVE_ROOM_LIST",
  "data": {
    "room_id_list": [
      24293130,
      24505565,
      26383010,
      1610110,
      25420809,
      25784026,
      26586646,
      26681221,
      26681376,
      24309164,
      22403746,
      23471912,
      21417294,
      4752152,
      24190849,
      4538481,
      25659267,
      26686756,
      11386500,
      8909658,
      10871807,
      11516633,
      25396195,
      26530925,
      7918685,
      24307923,
      25164127,
      25482861,
      26174975,
      26693763,
      26693777,
      13037807,
      23322479,
      23607029,
      24501056,
      26687122,
      9789162,
      1538611,
      22948628,
      26129683,
      26645113,
      26677496,
      26684273,
      6285543,
      10855984,
      2841907,
      12499840,
      12713131,
      22534950,
      11014370,
      11824654,
      23284660,
      24198840,
      6884875,
      9407044,
      24066189,
      24767626,
      23143532,
      24864361,
      26207418,
      24785754,
      26373476,
      26628696,
      2785050,
      459126,
      5212146,
      23759166,
      24797736,
      26033402,
      549746,
      23393126,
      24864500,
      25224777,
      25987746,
      260522,
      3125404,
      4787988,
      5907283,
      7227977,
      8395346,
      936384,
      1421371,
      24785702,
      24820891,
      25630240,
      25837089,
      26635450,
      2190411,
      24492912,
      24767778,
      25178303,
      21196921,
      25283324,
      25286659,
      26329681,
      26692312,
      5725111,
      11924810,
      25279647,
      25935120,
      5230461,
      25540392,
      25991324,
      26149407,
      24104971,
      6051912,
      6439406,
      9763974,
      22419214,
      2264335,
      25007759,
      26625783,
      9733286,
      23925291,
      25812557,
      25870421,
      6882752,
      24911782,
      26689138,
      7811144,
      163235
    ]
  }
}