{
  "cmd": "STOP_LIVE_ROOM_LIST",
  "data": {
    "room_id_list": [
      30220569,
      30903879,
      31294284,
      4644381,
      626486,
      24928116,
      26267329,
      26290885,
      27485400,
      30213406,
      30563529,
      30663799,
      31302615,
      26288327,
      30211307,
      30211939,
      30563409,
      31317008,
      22502576,
      22538220,
      30886437,
      31088270,
      3251503,
      23520767,
      27089459,
      30578919,
      30594857,
      31237819,
      24721419,
      26318557,
      30214499,
      30903787,
      31330907,
      14028698,
      24680169,
      30666029,
      30922557,
      31237489,
      26472787,
      27025673,
      30521413,
      30885877,
      30922939,
      23092710,
      25724906,
      25769897,
      30595477,
      30907427,
      22643674,
      27256232,
      30211027,
      30211947,
      31331147,
      23535587,
      31277409,
      26076487,
      30211025,
      30264454,
      30597096,
      30692845,
      31266745,
      26325975,
      30220805,
      30633515,
      30732655,
      24788765,
      22952315,
      26616246,
      26778765,
      30005715,
      30211975,
      27256233,
      30742225,
      31272385,
      30834994,
      26647470,
      26867811,
      4997175,
      11460675,
      30215705,
      30654495,
      5363499,
      26707405,
      30327445,
      30595445,
      30633495,
      21716473,
      24430228,
      26778773,
      27256237,
      31128917,
      26111023,
      30779653,
      6454741,
      24362504,
      26599253,
      27860743,
      27876433,
      23750273,
      31058742,
      6480405,
      26636208,
      3284787,
      10928248,
      22586763,
      27256239,
      30238063,
      571477,
      23339273,
      23471553,
      4478585,
      24129837,
      27083923,
      30333059,
      30749871,
      30904381,
      11238656,
      24038254,
      26607111,
      24007810
    ]
  }
}