{
  "cmd": "STOP_LIVE_ROOM_LIST",
  "data": {
    "room_id_list": [
      10751211,
      12907931,
      1853018,
      22492720,
      22745744,
      26052221,
      26568771,
      524016,
      7138150,
      745321,
      23935480,
      25005430,
      25555912,
      25588243,
      25711360,
      26052220,
      26210590,
      26472409,
      26537248,
      26586440,
      26684273,
      161120,
      23007936,
      23885920,
      25948676,
      8890998,
      1291756,
      13799535,
      1615473,
      25154825,
      26683789,
      871402,
      12093471,
      24235262,
      25045802,
      25172999,
      25332372,
      22711290,
      23141672,
      25683626,
      25981402,
      26052502,
      26411032,
      26688228,
      21787975,
      22333016,
      26586456,
      21254245,
      21857214,
      24883466,
      25143386,
      26369530,
      26609715,
      26675546,
      604806,
      8445047,
      13281803,
      14639,
      22096345,
      23501145,
      26688922,
      625177,
      22008378,
      2350038,
      25946747,
      26139686,
      26496851,
      5431328,
      13390699,
      25269896,
      22746576,
      25878566,
      26083492,
      26089615,
      26689401,
      3255231,
      5357912,
      24908010,
      26356950,
      26610073,
      5068015,
      24463156,
      25354815,
      25481089,
      26671900,
      23538374,
      25632701,
      26245702,
      26595353,
      26680632,
      9332012,
      21952975,
      24802120,
      25009063,
      25321305,
      26541809,
      26644366,
      3076936,
      5483898,
      8342853,
      22736140,
      26350095,
      4544237,
      1476438,
      1539798,
      19889,
      21625009,
      1172951,
      12405228,
      23619909,
      23743859,
      25698173,
      26545794,
      26592890,
      11977690,
      21848422,
      25309292,
      25416772,
      25564525,
      25759112,
      26087529,
      26598920,
      21630512,
      24747234,
      24749586,
      2584491,
      26559912,
      26666616,
      3445371,
      9617234,
      13385644,
      24372867,
      26579715,
      26496609,
      11283455,
      21597550,
      26688313,
      3236262,
      10341789,
      23559866,
      25602609,
      26072784,
      26639077,
      26269089,
      26637615,
      21570379,
      23962528,
      8229540,
      15156874,
      21596932,
      23273273,
      24986026,
      25171857,
      25633164,
      26567180,
      3705494,
      11742546,
      191653,
      22897239,
      25632695,
      26451142,
      4287634
    ]
  }
}