{
  "cmd": "STOP_LIVE_ROOM_LIST",
  "data": {
    "room_id_list": [
      22957906,
      26448039,
      23347639,
      26540656,
      4326135,
      21684599,
      25855204,
      24068883,
      25090129,
      6412284,
      25162254,
      26165400,
      26693477,
      24531040,
      10914495,
      26428813,
      26642007,
      4838818,
      1828102,
      21023169,
      25676823,
      26685838,
      26693710,
      5223606,
      6167630,
      920229,
      22734342,
      26650952,
      26683614,
      26691201,
      3759317,
      26683919,
      5155026,
      22980079,
      26250040,
      5553270,
      6068691,
      1647505,
      21572495,
      2279994,
      26600204,
      13262054,
      21318061,
      24118165,
      24485326,
      24924436,
      452949,
      15012545,
      24707466,
      25801658,
      26584886,
      3402116,
      4168761,
      13366524,
      23465231,
      4521131,
      23257911,
      24152861,
      26650474,
      26652323,
      26683365,
      2867879,
      5391999,
      6730929,
      10775399,
      21027459,
      25432294,
      26100013,
      26531627,
      26568179,
      26677413,
      26677414,
      5520399,
      13398263,
      25951396,
      2636025,
      9646821,
      12282273,
      22643833,
      24533793,
      25186622,
      6007573,
      24206569,
      25199068,
      25539458,
      25557161,
      25573493,
      8563353,
      22160748,
      26391221,
      4776168,
      1037276,
      24308525,
      25538764,
      26639863,
      26693791,
      22689647,
      28109,
      411963,
      4655122,
      23251656,
      23327839,
      24270748,
      24928344,
      11372386,
      24602120,
      857212,
      21297908,
      21495205,
      22270991,
      23773641
    ]
  }
}