{
  "cmd": "STOP_LIVE_ROOM_LIST",
  "data": {
    "room_id_list": [
      24160438,
      26685384,
      6063311,
      167612,
      21373262,
      25535567,
      26580164,
      26690712,
      3233348,
      6032706,
      778066,
      7834949,
      2027820,
      23692271,
      26580170,
      7383843,
      11410663,
      134373,
      22724210,
      26580172,
      26653596,
      668175,
      26686850,
      8520742,
      11807542,
      1645876,
      24744748,
      25979535,
      26036759,
      23296215,
      24543841,
      24726993,
      24799424,
      3857148,
      4520549,
      22833471,
      24206213,
      25987954,
      26218348,
      26591454,
      26690825,
      11772681,
      22897724,
      238083,
      26429225,
      26582453,
      292594,
      8839124,
      10420578,
      23722884,
      26662547,
      629124,
      23208253,
      8625099,
      1679858,
      1946743,
      21124419,
      21735200,
      22318514,
      26574977,
      26679702,
      1804183,
      1941104,
      23176002,
      24229475,
      25299281,
      26580842,
      26615844,
      2999638,
      14961537,
      26625582,
      23357373,
      23609672,
      23813225,
      25505856,
      25811133,
      26686914,
      736287,
      7583746,
      1883865,
      21490219,
      22058208,
      22250488,
      22897284,
      23200794,
      24290508,
      25820054,
      25988623,
      26527443,
      26690373,
      2858656,
      68049,
      22190160,
      26217861,
      26621474,
      26684019,
      5615616,
      5925367,
      1501992,
      22184146,
      24375429,
      24716038,
      25582293,
      26303553,
      26571377,
      26690730,
      7164476,
      23072779,
      23316068,
      25217740,
      26653018,
      26688221,
      3826971,
      575013,
      7733722,
      23369413,
      26246779,
      979521,
      22466486,
      23758266,
      2588410,
      26186157,
      4272547,
      13851069,
      1977651,
      25987341,
      26212995,
      26460091,
      12940508,
      2058827,
      23441340,
      23455693,
      26194768,
      26389881,
      4933718,
      8794568,
      10463222,
      12160354,
      25714498,
      25786626,
      26356295,
      4215202,
      5967261,
      7570691,
      8418051,
      869260,
      1582617,
      23514071,
      26021281,
      26680483,
      506836,
      6173733,
      9827641,
      13849741,
      1622919,
      23028111,
      24774940,
      24827469,
      26001212,
      26690381,
      26690507,
      9233183,
      11680464,
      15062041,
      22373369,
      23550163,
      23792681,
      25136061,
      26632817,
      26690441,
      5797199,
      760394,
      1673630,
      22019355,
      22284554,
      22801380,
      24325109,
      26690009,
      5751509,
      25018068,
      26411537,
      3259225,
      59469
    ]
  }
}