{
  "cmd": "STOP_LIVE_ROOM_LIST",
  "data": {
    "room_id_list": [
      21227037,
      22546639,
      26472401,
      15052710,
      23860742,
      24208409,
      26408563,
      1852988,
      22473390,
      24306423,
      25298698,
      5264137,
      5312687,
      6357198,
      23601978,
      25628536,
      25632684,
      5400894,
      10157925,
      11171638,
      22304997,
      24006993,
      25809409,
      26442570,
      26689154,
      3615434,
      14271685,
      24279170,
      25544994,
      26026093,
      3451085,
      654102,
      12200676,
      26461468,
      4736075,
      6096149,
      14476059,
      8455259,
      21746149,
      4532977,
      24154825,
      24186755,
      24368506,
      949186,
      14194909,
      22793164,
      7329258,
      8424022,
      10930619,
      24411176,
      887155,
      11163298,
      13160446,
      23917078,
      24751585,
      10671033,
      1082847,
      24041235,
      24156143,
      24228268,
      26052218,
      26452578,
      22422628,
      244333,
      25662262,
      26672748,
      9963933,
      22820979,
      25632706,
      25711213,
      26052213,
      26689522,
      3771663,
      616175,
      10744959,
      21030199,
      21774573,
      24118187,
      25558896,
      25607849,
      26052219,
      26149252,
      26689550,
      722943,
      15009857,
      25197679,
      25911759,
      26173119,
      26347325,
      26586419,
      26686444,
      12115558,
      25696648,
      25824719,
      21769324,
      24228324,
      24379894,
      24600861,
      26052214,
      26586394,
      26683031,
      4969097,
      7060377,
      21768545,
      22246114,
      23486084,
      23530801,
      26622163,
      26689112,
      3841237,
      24361252,
      24571507,
      24706605,
      12210689,
      1292193,
      2058469,
      24188059,
      26513408,
      5100885,
      19589,
      25663485,
      26688670,
      8252220,
      1088336,
      160168,
      26594085,
      11109357,
      22795461,
      25493810,
      25632703,
      26052217,
      26228956,
      26443667,
      26566374,
      26581976,
      903568,
      21593287,
      23345562,
      23547248,
      24693715,
      26040507,
      3229097,
      1413520,
      21308937,
      24084247,
      24922347,
      1518733,
      21552224,
      24228411,
      24648619,
      25141941,
      25816443,
      26461479,
      26470168,
      5974200,
      7858360,
      7901545,
      8104572,
      25930508,
      26052521,
      4910772,
      7010733,
      9068985
    ]
  }
}