{
  "cmd": "STOP_LIVE_ROOM_LIST",
  "data": {
    "room_id_list": [
      14292002,
      1704909,
      24890772,
      26535731,
      26688280,
      13721926,
      26045861,
      23049122,
      26624158,
      6733244,
      22575911,
      24135162,
      24893218,
      26132135,
      26314709,
      26539075,
      26580443,
      26665277,
      23134402,
      26484037,
      3535323,
      21679351,
      13602676,
      25676396,
      25938636,
      26300528,
      26349299,
      26514639,
      26690735,
      10411832,
      1339444,
      26203657,
      26663021,
      26683785,
      753670,
      21975644,
      24554396,
      26606767,
      768325,
      171869,
      2156003,
      22865503,
      23610730,
      25633119,
      8812137,
      25659943,
      1290074,
      14534529,
      25462138,
      838274,
      8917024,
      26679518,
      3554296,
      25542824,
      5145977,
      25754682,
      11880717,
      4823498,
      6859898,
      11967513,
      14618955,
      23731488,
      24263710,
      26121396,
      26138985,
      26221124,
      24349951,
      4201148,
      11955840,
      23826312,
      24409558,
      25342722,
      25378821,
      25841412,
      22650465,
      24863609,
      25938041,
      25035540,
      25176662,
      26220208,
      1536856,
      1673506,
      26312590,
      26660627
    ]
  }
}