{
  "cmd": "STOP_LIVE_ROOM_LIST",
  "data": {
    "room_id_list": [
      10118,
      11987661,
      22766252,
      24390282,
      25216788,
      4155762,
      6928915,
      1963835,
      23574765,
      23615150,
      25171070,
      26289666,
      26691205,
      8417257,
      22043426,
      23298664,
      24187356,
      26610298,
      3337081,
      4483818,
      26093554,
      26675403,
      4895223,
      24548087,
      4295561,
      4379004,
      10237095,
      13086878,
      24785211,
      25911152,
      26107668,
      26423473,
      26622592,
      13689042,
      21724415,
      25124634,
      6808625,
      23811719,
      26318764,
      26691228,
      3316777,
      6304230,
      8897734,
      1452107,
      21440535,
      22893708,
      23664605,
      25858443,
      9110006,
      15025229,
      24125801,
      24285449,
      256631,
      26379376,
      22704251,
      22840750,
      23064123,
      26013929,
      3685104,
      9979957,
      190693,
      22257814,
      24275324,
      24742384,
      26684196,
      11773740,
      3540994,
      4387149,
      22009243,
      25994318,
      26224803,
      26467,
      26662758,
      1420613,
      21664196,
      22486835,
      25554039,
      57584,
      25176766,
      4995806,
      6629188,
      7963243,
      8402197,
      12549034,
      21514375,
      22688977,
      25975069,
      26120562,
      26555047,
      7984614,
      10791018,
      25959863,
      26445510,
      4959471,
      7204843,
      24466861,
      25701651,
      25936838,
      26103242,
      3789129,
      5979840,
      23305522,
      25624931,
      25664275,
      26582832,
      3224757,
      6649765,
      25440301,
      25442324,
      26255946,
      26606362,
      4585124,
      5224052,
      5319534,
      6665165,
      24104785,
      24474534,
      25668953,
      26643169,
      6297705,
      9736747,
      13130067,
      22980302,
      24598128,
      5464938,
      847009,
      1101862,
      205191,
      21631338,
      23235767,
      25945872,
      25992050,
      26113632,
      26499749,
      26690067,
      4383479,
      4834108,
      5765998,
      11780383,
      1541728,
      22762988,
      24508731,
      24964218,
      4078598,
      1284849,
      25173383,
      25242060,
      25581948,
      25729243,
      26032818,
      26167546,
      5583258,
      5620753,
      1081050,
      1867883,
      22508830,
      22612314,
      24630701,
      25468313,
      10395814,
      1363300,
      2083843,
      21462810,
      23971099,
      26213583,
      26655285,
      26661897,
      22193793,
      23506289,
      24089993,
      25848706,
      26199193,
      26266884,
      26339063,
      8925233,
      26648480,
      26690317
    ]
  }
}