{
  "cmd": "STOP_LIVE_ROOM_LIST",
  "data": {
    "room_id_list": [
      23285497,
      25093123,
      26649296,
      5114320,
      5709686,
      6664204,
      22855553,
      23617951,
      24975192,
      25174336,
      26458847,
      6711790,
      8210729,
      13044736,
      13471420,
      22234311,
      22709417,
      22889518,
      24346669,
      25831879,
      7993537,
      1670383,
      26220097,
      4958047,
      5524279,
      24773998,
      2621525,
      26227349,
      26353743,
      26452596,
      3530756,
      461278,
      5773741,
      6868680,
      10204800,
      1223584,
      1365776,
      22175082,
      26026664,
      26557077,
      26626508,
      10095316,
      25443410,
      25805794,
      25889042,
      25944867,
      4455465,
      8080175,
      11699572,
      21317178,
      282779,
      1179035,
      21390675,
      22090973,
      23398268,
      23404635,
      24199647,
      24918068,
      25193115,
      26616916,
      12516154,
      12593586,
      24214748,
      26608060,
      3352124,
      457788,
      4590778,
      4909854,
      143829,
      1762194,
      24408275,
      26691227,
      30954,
      5981189,
      22581188,
      22862644,
      26173934,
      26681861,
      2695155,
      3060252,
      8638358,
      22079136,
      22580847,
      25552125,
      26660993,
      14314749,
      24244232,
      24368345,
      26027301,
      8840570,
      22681649,
      23764046,
      23998075,
      25463574,
      25927121,
      26302893,
      26669151,
      13283103,
      1683861,
      21820033,
      23864564,
      26619331,
      8688111,
      887931,
      9226785,
      1307971,
      21325716,
      21513440,
      22018389,
      22730379,
      24103541,
      26160016,
      5614430,
      7317985,
      12592311,
      24725702,
      7806529,
      11696006,
      23323918,
      23551000,
      24026539,
      26670165,
      7097979,
      13800996,
      24088677,
      25533876,
      26108304,
      26691219,
      2995360,
      22291027,
      23701053,
      24724718,
      1735386,
      22955787,
      24326195,
      25057979,
      25860292,
      2591585,
      26479304,
      404875,
      7071232,
      7660444,
      9167506,
      24151690,
      26009595,
      26194361,
      523763,
      7109147,
      12906022,
      23328890,
      23643480,
      9242875,
      1444227,
      22707653,
      23549171,
      25898831,
      26501858,
      7151743,
      10156419,
      14135255,
      25802600,
      26166172,
      7840637,
      866709,
      22462048,
      23347169,
      23787150,
      25556720,
      25844762,
      25882270,
      26551162,
      26691230,
      4080839,
      4970738,
      11083693,
      12590351,
      22196183,
      23865461,
      24332707,
      24718390,
      25167660,
      26072809,
      26233472,
      26646200,
      6486691,
      12232179,
      2305594,
      23625043,
      25606067,
      26328969,
      26409725,
      26545223,
      26558979,
      3760072,
      1276588,
      13085323,
      22336808,
      24518703,
      25473032,
      25491539,
      25810704,
      26344372,
      26561620,
      4996336,
      5212901,
      26093211,
      26478306
    ]
  }
}