{
  "cmd": "STOP_LIVE_ROOM_LIST",
  "data": {
    "room_id_list": [
      13244947,
      23423346,
      24261947,
      24374341,
      24454092,
      26605730,
      3490846,
      5497416,
      22374064,
      24578936,
      25530746,
      26605977,
      3782297,
      70767,
      952237,
      11974705,
      1975358,
      21765438,
      22773649,
      23689307,
      24212679,
      24376548,
      25594506,
      26691501,
      8071857,
      10040747,
      10287387,
      25104112,
      26393603,
      26591909,
      26676627,
      9554521,
      11549097,
      22027193,
      24972022,
      26315427,
      26393600,
      26616903,
      691836,
      22839369,
      22887932,
      23448475,
      24307511,
      25620179,
      25992980,
      26491140,
      24107058,
      25321412,
      25885840,
      13423031,
      14978338,
      21738639,
      24890160,
      25036394,
      26393756,
      6992616,
      8942374,
      1074645,
      25153845,
      25284378,
      26305680,
      26614634,
      4025078,
      617521,
      23244860,
      7870259,
      1122368,
      13423933,
      22228262,
      25020036,
      26690854,
      4412187,
      775804,
      8089586,
      14029578,
      21552592,
      22871191,
      24768196,
      25331818,
      26574125,
      26691351,
      6632730,
      14483523,
      14655405,
      21652717,
      22869891,
      23222061,
      25304932,
      2039398,
      21920628,
      22792519,
      23481892,
      2490216,
      25559713,
      26043424,
      26311932,
      4616517,
      10017077,
      14026175,
      14748265,
      25730275,
      26226007,
      4732373,
      7532710,
      21355063,
      24292955,
      26475600,
      10184783,
      2929491,
      13166973,
      14716422,
      24541077,
      25823390,
      26690617,
      26691456,
      5431469,
      22583494,
      22621404,
      23830887,
      25275193,
      26238497,
      26476351,
      26602433,
      5166833,
      1329138,
      2013808,
      21779129,
      22523490,
      22686999,
      23236602,
      24366430,
      2918573,
      10922255,
      11439711,
      22033629,
      23380055,
      23714079,
      24176534,
      26690489,
      26691518,
      3624344,
      21560520,
      22260089,
      22618376,
      26293135,
      26690799,
      37139,
      6264633,
      9773900,
      11557062,
      1847484,
      22878625,
      24337784,
      25471735,
      25897683,
      26419485,
      3287929,
      3744476,
      5747024,
      5808022,
      9180220,
      22188020,
      2268846,
      23076450,
      23362325,
      24318517,
      24581292,
      26086039,
      26588427,
      877585,
      9143705,
      12543184,
      23444749,
      24935351,
      25637715,
      26579032,
      3541021,
      392103,
      4680890,
      908106,
      22619187,
      22755091,
      24867938,
      25187489,
      25332696,
      26687194,
      54712,
      9017050,
      10107393,
      1345538,
      14617762,
      24650238,
      26279827,
      26539376,
      26617784,
      26667707,
      922897,
      10679784,
      1424525,
      14444203,
      23679127,
      24587649,
      26245845,
      26469639,
      7087648,
      9219255,
      1421933,
      24654155,
      25374749,
      25578481,
      3428723,
      644884,
      158209,
      21644406,
      23271389,
      25411771,
      26691457
    ]
  }
}