{
  "cmd": "STOP_LIVE_ROOM_LIST",
  "data": {
    "room_id_list": [
      13510916,
      22775630,
      23226617,
      25643845,
      26014883,
      26263321,
      26440304,
      2646075,
      340016,
      899496,
      10017855,
      22355062,
      26040842,
      26687287,
      26689575,
      3813527,
      3990174,
      26578494,
      475348,
      14231866,
      19866,
      22258000,
      25544376,
      25598225,
      26355587,
      6569580,
      8257853,
      23493786,
      26046718,
      567295,
      6091143,
      24624852,
      3094647,
      33340,
      3739372,
      23457823,
      26369524,
      26400254,
      26589520,
      5001189,
      23400769,
      23837420,
      24667909,
      25460152,
      5122830,
      10751940,
      12132641,
      12804843,
      26268145,
      26689506,
      7687373,
      22417435,
      22896048,
      4699939,
      7380456,
      1431475,
      22901801,
      23041792,
      26689070,
      417567,
      22131438,
      24130260,
      7964722,
      23991514,
      24382211,
      26423954,
      891530,
      21518813,
      22879506,
      22945548,
      24072285,
      24490844,
      24843613,
      25842234,
      26661503,
      917420,
      14864250,
      26611872,
      7511731,
      759969,
      13640579,
      14845201,
      23338549,
      2937350,
      4778291,
      8247415,
      24980067,
      2498322,
      26481027,
      902042,
      23304352,
      26351711,
      26687393,
      5620037,
      7293567,
      7474196,
      7781005,
      9771923,
      22616267,
      22637010,
      25632718,
      26480245,
      5796847,
      949040,
      1096636,
      24305157,
      24556738,
      25037580,
      26325516,
      26689578,
      2680297,
      490824,
      5001653,
      21957537,
      21958079,
      25045362,
      26116567,
      26552066,
      312613,
      3512682,
      5928194,
      9804950,
      1820025,
      2210595,
      23487808,
      25454840,
      26094465,
      1258762,
      2978681,
      7470722,
      22277966,
      24242840,
      25578884,
      25718454,
      25746825,
      2878525,
      4030094,
      4634465,
      8455259,
      11592070,
      25236433,
      25262927,
      25379351,
      12823238,
      26681644,
      4050326,
      5888725,
      23401627,
      24205555,
      26659873,
      7242703,
      8245755,
      11611753,
      13442862,
      21821438,
      22810754,
      2300623,
      23155203,
      23944851,
      25802352,
      26188415,
      26587523,
      12641560,
      25518406,
      25492370
    ]
  }
}