{
  "cmd": "STOP_LIVE_ROOM_LIST",
  "data": {
    "room_id_list": [
      22363634,
      24502240,
      3422258,
      7669178,
      23459331,
      26164051,
      4644456,
      24308504,
      5520399,
      5626756,
      26040560,
      2683667,
      24225778,
      7308286,
      25990666,
      1385068,
      25420009,
      25543768,
      26392631,
      22901181,
      24616425,
      25477719,
      3283424,
      4221218,
      861144,
      13802459,
      25486532,
      26511035,
      13731275,
      25568445,
      25787546,
      26390985,
      26686085,
      26693765,
      7902051,
      26414400,
      24975632,
      26337772,
      4718614,
      9677222,
      22207507,
      23753642,
      23995586,
      2461562,
      25633183,
      25943527,
      5779124,
      2357187,
      25731487,
      4037177,
      12696671,
      23247488,
      23261503,
      25676981,
      26159971,
      26218841,
      21197548,
      22975721,
      25739363,
      25697651,
      26665798,
      26686978,
      26693648,
      21790374,
      23004532,
      26461634,
      26687609,
      24188049,
      25117856,
      25611453,
      8390638,
      11838515,
      12579920,
      13143424,
      24311680,
      25342266,
      26649622,
      21087035,
      26552820,
      4478585,
      7866924,
      11823574,
      24635231,
      24747381,
      25070751,
      26693779,
      4615453,
      13972110,
      14713727,
      23980268,
      25303916,
      26058077,
      25710969,
      26679810,
      4137997,
      11674965,
      24531936,
      24698473,
      25230798,
      25349978,
      25399544,
      24033063,
      26088213,
      26533049,
      4395554,
      21430663,
      1401649,
      9784614
    ]
  }
}