{
  "cmd": "STOP_LIVE_ROOM_LIST",
  "data": {
    "room_id_list": [
      23239524,
      25880696,
      26564810,
      26566453,
      12234907,
      21230016,
      22419483,
      24461525,
      25440828,
      25856448,
      8003937,
      9150511,
      23954511,
      26505763,
      9395739,
      23779007,
      25415037,
      26623758,
      23794518,
      25396306,
      25489424,
      25939173,
      3221840,
      13106559,
      21780575,
      23144411,
      26693655,
      22247513,
      25062062,
      26557611,
      5308608,
      5503269,
      25206790,
      26138518,
      25248490,
      25603576,
      23439915,
      26511059,
      26677758,
      6886485,
      12294819,
      24368239,
      26277246,
      26667417,
      10404174,
      24471766,
      26367631,
      4033156,
      23584998,
      26635546,
      592060,
      12437687,
      22056770,
      2485576,
      26568698,
      26672569,
      13149455,
      24212270,
      26580443,
      12199323,
      14810587,
      24424049,
      10571501,
      652243,
      22887523,
      23870539,
      26466902,
      7487132,
      26337361,
      26320971,
      22278843,
      26693832,
      25516584,
      4857475,
      5155026,
      13335158,
      14742758,
      21501850,
      671749,
      921353,
      25433368,
      55405,
      2117916,
      3373785,
      22346410,
      24092962,
      26216176,
      26693589
    ]
  }
}