{
  "cmd": "STOP_LIVE_ROOM_LIST",
  "data": {
    "room_id_list": [
      24606312,
      24795865,
      2838691,
      491699,
      23497768,
      3874456,
      7936612,
      26091210,
      21833932,
      13150902,
      26608384,
      26667954,
      26948,
      21946532,
      22173635,
      22389377,
      11338811,
      26429193,
      24132341,
      26389290,
      15158875,
      25536152,
      25680329,
      25953648,
      26505379,
      22877422,
      26683139,
      1206243,
      24969622,
      376874,
      21483073,
      24367158,
      26693271,
      26362630,
      22312131,
      24086180,
      24354398,
      24482281,
      11969214,
      21257353,
      25118338,
      3746057,
      6517223,
      915491,
      25838044,
      8485481,
      24287228,
      25932506,
      26247999,
      11637204,
      23307255,
      24902090,
      26518674,
      6819996,
      23111182,
      5237527
    ]
  }
}