{
  "cmd": "STOP_LIVE_ROOM_LIST",
  "data": {
    "room_id_list": [
      25227228,
      5680040,
      8976243,
      22943405,
      23668079,
      23681932,
      25129235,
      5415487,
      9032148,
      25696634,
      25941853,
      26476427,
      7260188,
      9202203,
      26072965,
      11245827,
      11215033,
      24552119,
      14177841,
      21909839,
      22836435,
      25011283,
      8524363,
      3324295,
      8506219,
      23083082,
      26657278,
      1191524,
      25826540,
      26530875,
      14175584,
      26005233,
      26587104,
      1731987,
      24040434,
      25419544,
      25983907,
      26581686,
      26586414,
      12174136,
      22437402,
      24629129,
      7198077,
      23383914,
      25240446,
      25836600,
      26662928,
      3463006,
      26100338,
      9319350,
      23008603,
      24456369,
      25495424,
      25552567,
      26647168,
      26682732,
      21560497,
      26068668,
      26484992,
      6792477,
      23141383,
      25337470,
      25628052,
      2589472,
      3678638,
      932448,
      26657302,
      26690709,
      12071092,
      26534368,
      13335655,
      26064651,
      1458575,
      24107429,
      826517,
      25136886,
      25571954,
      25674948,
      26566860,
      2958462,
      3113777,
      4676731,
      23882771,
      26282988,
      24945203,
      661271,
      9008611,
      715087,
      25249577,
      26112639,
      23956250,
      24243658,
      25675924,
      26682659,
      5173375,
      91999
    ]
  }
}