{
  "cmd": "STOP_LIVE_ROOM_LIST",
  "data": {
    "room_id_list": [
      23377533,
      24067235,
      23716196,
      26044237,
      26680859,
      14642257,
      25295034,
      25988034,
      26680857,
      21704093,
      23788440,
      21665839,
      23688048,
      26281925,
      26638198,
      26677827,
      10613800,
      24055596,
      24552586,
      25885029,
      5238666,
      928060,
      21361019,
      22215608,
      23211860,
      26693618,
      10687249,
      3937009,
      192449,
      23763367,
      3710560,
      13916192,
      22904476,
      22968134,
      24311352,
      26612591,
      3991973,
      5926848,
      23516237,
      26287634,
      26434942,
      26550615,
      8704697,
      12090964,
      24660287,
      24888507,
      9740843,
      1177792,
      23551949,
      24714643,
      26062791,
      7624862,
      24354124,
      4233028,
      1527193,
      25093529,
      388119,
      7641000,
      26075590,
      23740829,
      9668867,
      26693817,
      22045372,
      22890339,
      23603740,
      26123803,
      10908559,
      25282880,
      25895955,
      4554732,
      22495923,
      23367741,
      24530010,
      26688547,
      610852,
      23458114,
      24840711,
      25608387,
      26351755,
      283022,
      1057279,
      11288842,
      12919310,
      26192775,
      6855779,
      26688843,
      21177159,
      24248925,
      26614849
    ]
  }
}