{
  "cmd": "STOP_LIVE_ROOM_LIST",
  "data": {
    "room_id_list": [
      22692698,
      23419163,
      14449255,
      21206544,
      24306749,
      336401,
      101960,
      13620880,
      1500241,
      21526490,
      22048267,
      24166793,
      26031641,
      26293627,
      26640935,
      3043816,
      11564521,
      22946778,
      26551004,
      12652002,
      13275739,
      22328084,
      22527706,
      24479264,
      2469567,
      25210246,
      25243595,
      25460351,
      25820582,
      5516579,
      14791043,
      24030477,
      26245754,
      26410958,
      26595914,
      26665394,
      26683427,
      26685340,
      9864969,
      24292542,
      26641180,
      3627136,
      6452475,
      12370936,
      1448020,
      24261547,
      24841820,
      26092205,
      4376815,
      58080,
      10952165,
      12202615,
      12579705,
      24661,
      25138376,
      25783929,
      3367331,
      70911,
      22196355,
      24038035,
      26040998,
      11986112,
      23191000,
      23418302,
      26000727,
      26613477,
      4752378,
      6566038,
      24660299,
      25896036,
      26073277,
      26533039,
      26652358,
      12887525,
      21157021,
      24774105,
      25235784,
      25964769,
      26257914,
      4487117,
      4832553,
      708138,
      4534426,
      7977644,
      26105942,
      26323320,
      465723,
      5230200,
      10319478,
      14173742,
      21285310,
      21715179,
      23989757,
      24281381,
      26644777,
      26691040,
      26691520,
      3127867,
      7767448,
      11928477,
      21967698,
      24217410,
      25813666,
      26345177,
      6083650,
      8632970,
      25928206,
      5207737,
      11775698,
      2225823,
      22940631,
      26054776,
      26138239,
      26274832,
      6861182,
      920339,
      23449226,
      23481152,
      23492856,
      2379219,
      2519401,
      25304534,
      25526479,
      25754946,
      26225958,
      26680893,
      3093576,
      5914013,
      7224638,
      1823302,
      24373210,
      26438983,
      3607965,
      524376,
      11986,
      12225285,
      23275499,
      24062970,
      24308083,
      25645947,
      26120195,
      26627671,
      822952,
      22539385,
      26190885,
      31507,
      460446,
      9112587,
      1071916,
      11083233,
      14743391,
      23947403,
      25312113,
      25870696,
      26161370,
      26420983,
      26522431,
      26562983,
      5789649,
      22035845,
      22375368,
      23159525,
      24134703,
      26287194,
      26450220,
      5598233,
      6629732,
      10367875,
      22949094,
      25334791,
      26235616,
      26414981,
      26506611,
      26670569,
      26691225,
      6177786,
      7332399,
      8543013,
      2040241,
      26196271,
      26355812,
      26564248,
      26586676,
      26671206,
      3450603,
      56529,
      7064916,
      9401720,
      22255787,
      236055,
      23711346,
      25541286,
      26177727,
      2761795,
      5627006,
      8757214,
      13251496,
      25143740,
      26266596,
      26343368,
      26496948,
      2889025,
      10290772,
      26295444,
      4381158,
      5582874,
      26203791
    ]
  }
}