{
  "cmd": "STOP_LIVE_ROOM_LIST",
  "data": {
    "room_id_list": [
      12632107,
      26570175,
      8406801,
      1266729,
      22435083,
      22864707,
      25313280,
      5966079,
      6271217,
      21365932,
      24391363,
      218240,
      22652624,
      26093105,
      26383567,
      26581786,
      25789204,
      26050811,
      8795969,
      26498603,
      7457505,
      22435005,
      25978425,
      9393424,
      26288968,
      26693817,
      7383886,
      11614226,
      21212553,
      24551661,
      25813698,
      26693496,
      5164158,
      5626756,
      1328536,
      21439174,
      25360316,
      26320856,
      26693770,
      5539206,
      10615971,
      1468866,
      21890831,
      22815804,
      25546712,
      25801784,
      25814538,
      25997163,
      26665047,
      5748684,
      1486928,
      22476819,
      26620352,
      9342512,
      10164969,
      12562713,
      24975632,
      502893,
      23161231,
      23436414,
      24295387,
      25265172,
      25331387,
      25871876,
      26515012,
      23395320,
      24209176,
      26052502,
      26288667,
      13129760,
      21577350,
      25267281,
      25676068,
      25958736,
      26384770,
      26664770,
      8961885,
      23147338,
      23317889,
      4614706,
      21145228,
      26040507,
      26432307,
      6940831,
      26287634,
      26641593,
      21348103,
      22331367,
      23566477,
      25489451,
      26601533,
      26664982,
      2847091,
      4766290,
      14983971,
      24161513,
      25071950,
      25585401,
      26052221,
      26052521,
      26091746,
      26584461,
      23618982,
      25021918,
      26477981,
      26688090,
      14101204,
      949748,
      23034110,
      26398532,
      26598330,
      25400620,
      5188077,
      5574275,
      25026855,
      26315813,
      26581290,
      10544900,
      1657769,
      3121563,
      6859610,
      23793454,
      25153008,
      26414201
    ]
  }
}