{
  "cmd": "STOP_LIVE_ROOM_LIST",
  "data": {
    "room_id_list": [
      22130755,
      24130053,
      337022,
      6818564,
      9505391,
      14358154,
      23423411,
      25578492,
      25973617,
      26575296,
      878028,
      22241849,
      24354308,
      24418283,
      25651751,
      25971854,
      395152,
      21618479,
      23056093,
      23653499,
      26260281,
      26600485,
      26689770,
      6238064,
      8111876,
      22287962,
      22469178,
      22862470,
      23145905,
      24049182,
      26466457,
      26690909,
      9070347,
      22129549,
      24222429,
      26170612,
      1720847,
      2014376,
      21905102,
      22514604,
      23907721,
      25066030,
      141860,
      15106385,
      22004873,
      22851273,
      24166749,
      5864233,
      23771386,
      25896090,
      25948918,
      26677774,
      310831,
      7280057,
      11597852,
      21649259,
      22776544,
      25676109,
      25822508,
      4371488,
      6961404,
      14511576,
      14965860,
      21230586,
      21378753,
      23020264,
      25251420,
      25713261,
      26444316,
      26683111,
      13218892,
      13496286,
      22120081,
      26661667,
      26689207,
      22502719,
      23881984,
      24279512,
      24439143,
      24702140,
      256199,
      26677448,
      26690894,
      6930347,
      12042494,
      12886847,
      23875670,
      25959464,
      26690282,
      8727517,
      15095430,
      22363112,
      23963958,
      24088728,
      25571814,
      2878681,
      9333948,
      23774274,
      24222772,
      25123611,
      25998943,
      26254010,
      5217198,
      21526037,
      24306868,
      25306386,
      281482,
      9397448,
      9688981,
      10254630,
      21261808,
      22643380,
      22792387,
      23123643,
      24981612,
      25920398,
      26503587,
      26669635,
      2734381,
      466695,
      8865152,
      171142,
      25148109,
      25235370,
      25802874,
      633568,
      11526809,
      26094848,
      3081110,
      1995801,
      21392690,
      22975513,
      25363023,
      25568287,
      25694350,
      26393686,
      26655172,
      5088592,
      5352292,
      7199025,
      863557,
      2030663,
      2223605,
      24871268,
      26553588,
      26566593,
      26632067,
      525045,
      2174229,
      23349377,
      26667797,
      907638,
      13155807,
      21574224,
      22989537,
      239021,
      24316184,
      24336406,
      25594855,
      26555429,
      26688758,
      68757,
      7735128,
      9208822,
      21312264,
      24091258,
      24649996,
      25031275,
      25623628,
      9480045,
      14941332,
      21510721,
      25499270,
      26151243,
      2979886,
      3602083,
      3745042,
      8387822,
      21043904,
      2241976,
      25972116,
      26550292,
      23552855,
      23584580,
      25814819,
      26047863,
      26656254,
      26677082,
      3835912,
      5877186,
      24108022
    ]
  }
}