{
  "cmd": "STOP_LIVE_ROOM_LIST",
  "data": {
    "room_id_list": [
      23892481,
      24911416,
      3503298,
      5365900,
      7172317,
      14649049,
      1072431,
      25601913,
      26481971,
      26643161,
      23232406,
      26276018,
      5790946,
      6359607,
      26579230,
      26652310,
      26670569,
      9561443,
      14084949,
      21622582,
      23284317,
      23641218,
      24245474,
      24363382,
      24389073,
      981982,
      1022212,
      12388395,
      24263435,
      24440765,
      26141036,
      11156235,
      23525746,
      24049985,
      24172305,
      24368075,
      24836545,
      25315406,
      26030541,
      10770729,
      24300441,
      25450615,
      25520286,
      5523172,
      24339703,
      6342283,
      6912254,
      11424352,
      24347764,
      24368263,
      428247,
      25162254,
      26644914,
      24376137,
      24675787,
      24707541,
      26628212,
      21948457,
      22091054,
      24724681,
      25755330,
      25928063,
      26340094,
      8870980,
      2433270,
      22305425,
      22868880,
      24314806,
      24816146,
      25001273,
      26474080,
      7198077,
      8213420,
      11650409,
      25174251,
      26661017,
      26693566,
      3397251,
      6998506,
      2128272,
      26270665,
      22645720,
      26655628,
      26693629,
      24303549,
      24368188,
      26574780,
      12210689,
      1418031,
      21381031,
      25662699,
      26678900,
      21881927,
      26608907,
      9035988,
      21439319,
      154341,
      23358856,
      25885840,
      26658217,
      8915601,
      12181301,
      24995676,
      26006422,
      26179715,
      6432537,
      8812137,
      9717006,
      13954122,
      24111095,
      25598722,
      26438849
    ]
  }
}