{
  "cmd": "STOP_LIVE_ROOM_LIST",
  "data": {
    "room_id_list": [
      26693809,
      25089738,
      25484199,
      23671873,
      25516089,
      26100320,
      26582925,
      26681795,
      24363270,
      26613643,
      26667659,
      26693589,
      26669679,
      4722415,
      23081542,
      25834475,
      25844967,
      3189050,
      23227863,
      23756843,
      25420809,
      10660298,
      26311990,
      26660779,
      33495,
      22370254,
      25225652,
      25329763,
      26690899,
      1392434,
      23356505,
      25315013,
      26643042,
      24126054,
      2444016,
      26346278,
      26627273,
      26693316,
      394705,
      7197530,
      22558325,
      23716196,
      26400993,
      25300417,
      26112325,
      24484430,
      24530700,
      24873834,
      26280231,
      26690133,
      8193864,
      23875124,
      23458114,
      25413264,
      26686000,
      24256858,
      764155,
      9617072,
      14131785,
      26228517,
      26402149,
      4780958,
      6169720,
      10196923,
      25706006,
      26497551,
      4276299,
      4977590,
      7401163,
      13791965,
      21733513,
      22622447,
      24614589,
      25624424,
      26390985,
      9799807,
      26626001,
      11306,
      23855275,
      25779603,
      6130011,
      470651,
      7067437,
      8775741,
      25579036,
      26693797
    ]
  }
}