{
  "cmd": "STOP_LIVE_ROOM_LIST",
  "data": {
    "room_id_list": [
      21998812,
      22479847,
      25976495,
      3185246,
      5687984,
      1710807,
      24500885,
      26495160,
      26688792,
      4034991,
      4072416,
      10823681,
      1498339,
      15056525,
      23233260,
      23377471,
      23492881,
      2638971,
      26567830,
      26644826,
      22775519,
      26563439,
      26577486,
      22005117,
      22615249,
      25014084,
      2539380,
      12310625,
      22354373,
      22915832,
      23871770,
      26048718,
      26276990,
      5438331,
      14624164,
      14998956,
      25632715,
      26658056,
      26682803,
      26689536,
      290272,
      10872496,
      24167616,
      26596470,
      328698,
      6267926,
      7043220,
      26138915,
      26373599,
      9573166,
      23498289,
      26234627,
      26689375,
      3179128,
      21808954,
      22318299,
      22869909,
      22879506,
      24646842,
      25206057,
      26441461,
      26549938,
      26574398,
      24913322,
      26288358,
      26453093,
      9447841,
      23392823,
      26245313,
      30119,
      404058,
      14203427,
      25600513,
      11443132,
      2189604,
      24450044,
      25167290,
      26534585,
      10249599,
      24876718,
      25371906,
      25991453,
      31609,
      4807148,
      7387041,
      10289849,
      22349804,
      23220691,
      25632712,
      2727492,
      8753142,
      22863377,
      26680733,
      6488559,
      26286330,
      26689570,
      21777072,
      23716484,
      23866002,
      3026295,
      9015183,
      25561125,
      26446324,
      6051730,
      771310,
      25333433,
      3937820,
      22410170,
      4236586,
      6516049,
      7617908,
      9736325,
      24924526,
      26316879,
      26666940,
      509476,
      216685,
      24320197,
      26536742,
      24059104,
      25960518,
      8843589,
      22152493,
      22995229,
      24015984,
      24188489,
      25690420,
      26108147,
      11348432,
      21891149,
      23073288,
      25051817,
      25632710,
      26319894,
      26689487,
      394438,
      21552599,
      25992567,
      26606681,
      10268226
    ]
  }
}