{
  "cmd": "STOP_LIVE_ROOM_LIST",
  "data": {
    "room_id_list": [
      11650552,
      21728845,
      22896798,
      24142706,
      25846393,
      26522592,
      4010705,
      1202788,
      22802646,
      23724057,
      24424124,
      24678436,
      25212281,
      26380761,
      272784,
      23904692,
      2522332,
      25996274,
      26149827,
      26466221,
      76526,
      77386,
      1910981,
      21459817,
      22848196,
      23544782,
      25736273,
      26552946,
      26573410,
      26644872,
      3566742,
      25557439,
      25803431,
      26574693,
      26690839,
      22718501,
      24468113,
      26310060,
      26311254,
      7219203,
      25883397,
      26690379,
      7170923,
      25679595,
      25757603,
      4538753,
      13420683,
      22600333,
      26011698,
      3413911,
      4624552,
      21270265,
      24514517,
      26126309,
      26310049,
      26491486,
      26661644,
      26691213,
      343870,
      3450209,
      26578390,
      22111095,
      22523681,
      24959801,
      25598340,
      26414097,
      26662474,
      514545,
      692672,
      11126934,
      1229882,
      21777770,
      23151984,
      24071352,
      24255683,
      24469882,
      26282255,
      26571196,
      24406454,
      25420178,
      25426232,
      26254757,
      26584423,
      1250402,
      25963454,
      26214138,
      6420434,
      7711417,
      8389835,
      10464557,
      12240118,
      1284849,
      13768443,
      23080165,
      23321311,
      422439,
      4230383,
      629675,
      12796099,
      23948703,
      25534107,
      26103897,
      26491298,
      3547962,
      4925773,
      9083523,
      12589705,
      21641160,
      25608857,
      26136817,
      26641258,
      4881319,
      796408,
      14762490,
      25491912,
      25555919,
      26405693,
      26691239,
      9544365,
      23918141,
      24925507,
      24934611,
      25814312,
      25932965,
      26611075,
      5973525,
      9452375,
      21461918,
      22867656,
      25332407,
      25941127,
      26501858,
      26691152,
      5533200,
      8153987,
      1017425,
      11494424,
      1180629,
      12734282,
      22094520,
      22451014,
      25859682,
      25867537,
      26174274,
      26436705,
      26660093,
      26677168,
      3576349,
      24717307,
      2753806,
      4664261,
      757199,
      8855225,
      11013137,
      146528,
      21876449,
      24623532,
      24630639,
      26671757,
      3042179,
      6888996,
      13281006,
      1932999,
      24148156,
      26624668,
      26689679,
      26691075,
      6954132,
      9764061,
      11007232,
      22651050,
      22736912,
      22743879,
      24984670,
      25207903,
      26428783,
      26677068,
      69316,
      22289457,
      25187514,
      25626552,
      26328162,
      266582,
      5311889,
      10167199,
      11273572,
      2253637,
      23262142,
      25561610,
      26287921,
      26682199,
      278945,
      1177941,
      1389742,
      21229642,
      22562469,
      25487999,
      26059857,
      26535566,
      26690748,
      6903476,
      901375,
      983589,
      21575395,
      21819159,
      24690415,
      3898022,
      5463935,
      1749657,
      22812742,
      25210448
    ]
  }
}