{
  "cmd": "STOP_LIVE_ROOM_LIST",
  "data": {
    "room_id_list": [
      25255501,
      25977442,
      26690549,
      11853239,
      21920628,
      2198357,
      24755429,
      24901783,
      26339984,
      26688554,
      5731402,
      12923814,
      14929347,
      22820377,
      24474463,
      26508120,
      551604,
      1424955,
      24879062,
      2577239,
      296290,
      61584,
      8838245,
      21576607,
      2354685,
      25447125,
      26643166,
      3200432,
      13429597,
      14663962,
      23292775,
      23944504,
      23999996,
      25336791,
      26564855,
      8031656,
      879094,
      10277661,
      1112094,
      25656264,
      26690154,
      10391916,
      220825,
      22841562,
      23720547,
      960904,
      14409049,
      22647866,
      26494989,
      26571863,
      26635358,
      26646835,
      304772,
      7226723,
      24062650,
      25368996,
      26178021,
      26683094,
      933341,
      10358988,
      14211872,
      14789799,
      2963249,
      3265153,
      22046440,
      25174870,
      25539785,
      26402612,
      2701811,
      42053,
      10149505,
      1173983,
      12016931,
      21556369,
      22310848,
      22477401,
      23053488,
      26665452,
      433074,
      13649551,
      15148242,
      17590,
      24210524,
      25206066,
      25621479,
      25922907,
      26618147,
      5576640,
      1380552,
      16661,
      21881352,
      22640885,
      25732265,
      26683593,
      6392969,
      21497869,
      22777778,
      22834435,
      23087542,
      24514675,
      24983730,
      25710640,
      26005472,
      26013019,
      26033760,
      26193313,
      26516482,
      2975902,
      13218892,
      13776710,
      21742113,
      26072533,
      2858656,
      9391490,
      167612,
      21430293,
      23167582,
      23265598,
      24574380,
      25360999,
      26682151,
      570432,
      7714399,
      24483049,
      2484117,
      25970462,
      26013356,
      5881847,
      6780029,
      10804341,
      24396223,
      24853267,
      26645143,
      26656128,
      3187671,
      4645542,
      12488184,
      22300879,
      24554799,
      25890984,
      26690643,
      14014754,
      22971408,
      23194730,
      24235159,
      24513182,
      25434754,
      26160985,
      26690797,
      7976449,
      24067146,
      24226301,
      24457243,
      24512033,
      26690776,
      3399326,
      3700750,
      13643766,
      26675664,
      7401197,
      11121872,
      26621476,
      26690495,
      4414293,
      4746713,
      5452022,
      5637231,
      8054994,
      1096904,
      23651762,
      249736,
      25102996,
      26186157,
      26517615,
      26572527,
      6301292,
      21497825,
      23605980,
      25977515,
      26071500,
      26493158,
      26674336,
      3694277,
      468517,
      11501570,
      12245943,
      23109988,
      25194480,
      25716420,
      13235533,
      26131418,
      3747680,
      4795854,
      5692148,
      9350199,
      10168444,
      11617068,
      24035808,
      24170308,
      24172112,
      25632584
    ]
  }
}