{
  "cmd": "STOP_LIVE_ROOM_LIST",
  "data": {
    "room_id_list": [
      12518961,
      12573067,
      24373712,
      11080943,
      25284508,
      25901162,
      26227686,
      705553,
      13830194,
      22086457,
      23273596,
      26690761,
      6961030,
      8148900,
      1339651,
      22899235,
      26470718,
      21125423,
      22405028,
      23393523,
      25572861,
      26687189,
      2783316,
      6133742,
      7330183,
      11124076,
      1726410,
      22048669,
      22122785,
      23233640,
      24264660,
      25002259,
      26335907,
      26394403,
      26552450,
      5752086,
      1460945,
      24764692,
      26665868,
      387446,
      5922374,
      8324895,
      13620727,
      14866732,
      21985722,
      22831287,
      25279826,
      26578260,
      3769456,
      11801272,
      25467848,
      26525167,
      26676534,
      11755138,
      26149289,
      8076893,
      13860853,
      23493434,
      25363836,
      23188545,
      26125482,
      26279827,
      26569833,
      26598846,
      4100374,
      796458,
      8803183,
      1337826,
      1585281,
      2080244,
      2343426,
      26149936,
      26332406,
      23503963,
      2611393,
      262055,
      26690643,
      29677,
      674198,
      25110224,
      25959365,
      26503640,
      26645943,
      2996931,
      5932289,
      7098189,
      24082796,
      26213569,
      26538850,
      12309511,
      21295161,
      21907769,
      23375035,
      23778725,
      26122375,
      10807352,
      2024684,
      24722622,
      25737932,
      26684308,
      5548792,
      10841004,
      12977742,
      23190860,
      23500605,
      23799897,
      24127388,
      24966470,
      26048297,
      26580391,
      376723,
      8576889,
      12923814,
      21932501,
      2292954,
      2522395,
      25410865,
      26391308,
      2672723,
      9636356,
      1264838,
      22681649,
      23105046,
      234812,
      26664754,
      4225585,
      10163181,
      10217852,
      10254452,
      24133730,
      24848595,
      25465439,
      25980262,
      26224802,
      26689802,
      7145155,
      13975689,
      21764215,
      22777355,
      25136061,
      25392327,
      25432981,
      2555891,
      26028824,
      26333582,
      26476138,
      4220453,
      9086848,
      10342799,
      10376813,
      150060,
      1608946,
      21988992,
      22520282,
      246132,
      25225438,
      25350892,
      25991887,
      26365465,
      26690841,
      3361332,
      10287763,
      11070429,
      22519051,
      23447731,
      24878245,
      25651851,
      26488791,
      11221498,
      12686786,
      12818650,
      22544913,
      24895411,
      25395791,
      26348700,
      26453881,
      36081,
      4018293,
      902251,
      22440975,
      25463301,
      26124091,
      26620805,
      26645178,
      3679231,
      766391,
      21424406,
      24084966,
      2465711,
      26058421,
      319791,
      4044860,
      12139061,
      23663337,
      25170391,
      25217978,
      25421676,
      26642443,
      4667570,
      6435592,
      8327156,
      10279334,
      11309163,
      1181568,
      21157052,
      26672761,
      3209214,
      3733752,
      26455245,
      26690798
    ]
  }
}