{
  "cmd": "STOP_LIVE_ROOM_LIST",
  "data": {
    "room_id_list": [
      21860542,
      2202309,
      25805264,
      26690024,
      26690758,
      25372439,
      25762205,
      26581065,
      4828060,
      1808648,
      22302637,
      26665326,
      12460733,
      14550245,
      23404569,
      23595185,
      2505469,
      22814200,
      23379571,
      24687876,
      26092965,
      26447164,
      8364796,
      13998635,
      14701786,
      14782970,
      22143496,
      22595575,
      23620741,
      25402623,
      25992592,
      26301055,
      3784430,
      4170777,
      25441207,
      26016243,
      26123910,
      26584972,
      11061197,
      12983222,
      26388247,
      26418093,
      26483759,
      26585480,
      26689315,
      26690242,
      4599160,
      14833043,
      23579492,
      23782248,
      25203597,
      25937992,
      26409658,
      1533522,
      1848447,
      22197580,
      23026686,
      23167462,
      24744089,
      24989352,
      26680292,
      5598336,
      24398531,
      24789618,
      25323169,
      26677375,
      12622339,
      22133334,
      24685073,
      26669429,
      6435593,
      7913718,
      13683331,
      23819822,
      25542983,
      26460610,
      26679274,
      26690764,
      26690946,
      9365885,
      12571761,
      14125065,
      21877548,
      24471029,
      5574963,
      6436375,
      17060,
      23392540,
      23594846,
      24519397,
      25572905,
      26647986,
      5168734,
      6165904,
      11410196,
      12474616,
      24357137,
      24534126,
      26690436,
      26690752,
      2990180,
      25341209,
      26558644,
      26688594,
      472082,
      12666781,
      22069268,
      23432013,
      23995778,
      25891309,
      26556065,
      26638347,
      26690874,
      2806334,
      287063,
      529510,
      13244431,
      15099339,
      26346421,
      385188,
      670782,
      1412449,
      21386559,
      22275707,
      22480821,
      23573861,
      23826045,
      24557723,
      25820321,
      26564338,
      26622621,
      280236,
      9897531,
      238320,
      24498305,
      25220016,
      25386655,
      25898512,
      26470851,
      5247360,
      8092811,
      12316963,
      24791210,
      24826421,
      25305525,
      3100154,
      25947338,
      26535923,
      26690935,
      3653353,
      8953558,
      11020226,
      11660353,
      23246731,
      23377425,
      23722835,
      25449685,
      25608396,
      25819126,
      26661913,
      26684875,
      4858394,
      8132179,
      24264754,
      24874225,
      26144442,
      26536441,
      5626251,
      7081393,
      8214702,
      980123,
      12038376,
      21170467,
      21311803,
      22814851,
      25949932,
      26502896,
      26688625,
      7032896,
      24170596,
      25882365,
      464422,
      861670,
      8721300,
      25311997,
      26142896,
      4506103,
      7748859,
      9999014,
      10230,
      14385801,
      25813107,
      25995400,
      26098576,
      26470457,
      26525214,
      4473687,
      4668651,
      247151,
      25682526,
      25713985,
      26053423,
      26238847,
      4537563,
      5126444,
      8167254,
      22959678
    ]
  }
}