{
  "cmd": "STOP_LIVE_ROOM_LIST",
  "data": {
    "room_id_list": [
      12388395,
      24664184,
      23145403,
      24016464,
      26544500,
      22481320,
      24266085,
      26644913,
      7146449,
      8967482,
      22328389,
      26642372,
      3466517,
      5754022,
      11896182,
      13937657,
      24301115,
      26693788,
      9277875,
      23417899,
      25933946,
      26201033,
      26693477,
      4868087,
      5080691,
      5280225,
      26477926,
      26616952,
      26693795,
      4265423,
      2003448,
      2626883,
      25982383,
      26691901,
      3719112,
      26326434,
      26669989,
      6466949,
      24076053,
      26693790,
      7406488,
      9935785,
      24613387,
      4934592,
      26692883,
      1216210,
      9843781,
      13706843,
      26394835,
      26502010,
      312153,
      1523918,
      24153023,
      21337552,
      22248231,
      23294209,
      24059516,
      25494920,
      23332150,
      25228491,
      24359934,
      24775489,
      7743667,
      26306863,
      26405487,
      3746369,
      26531627,
      21520392,
      3410077,
      5223606,
      22781802,
      2376830,
      25415543,
      25540368,
      10060228,
      25992751,
      26373599,
      26682947,
      11782378,
      13305243,
      22887523,
      24702403,
      25493229,
      8476119,
      21337824,
      22605658,
      26683613,
      3465429,
      11255653,
      14251621,
      21562583,
      25060146,
      25118338,
      26516081,
      26636009,
      26683398,
      5162605,
      8248994,
      2156003,
      5443534
    ]
  }
}