{
  "cmd": "STOP_LIVE_ROOM_LIST",
  "data": {
    "room_id_list": [
      21478490,
      24519703,
      24804040,
      25860180,
      7809333,
      11607103,
      1265410,
      26690882,
      8835811,
      24075282,
      26364893,
      26680022,
      26688963,
      26690943,
      26531245,
      24583138,
      25516292,
      25712783,
      26576518,
      26643166,
      9914988,
      10183841,
      23117817,
      24058430,
      25857293,
      26222977,
      26330895,
      26527558,
      49778,
      1407197,
      21159844,
      21906251,
      23861058,
      26312467,
      332573,
      23400337,
      24051050,
      25261907,
      26195762,
      3548643,
      7354466,
      8264892,
      1988505,
      22384948,
      25338887,
      26690707,
      3999238,
      439246,
      22406339,
      23233260,
      25247786,
      25913933,
      26532046,
      8179903,
      22879978,
      24288948,
      24679567,
      5751463,
      6017534,
      6238064,
      13090603,
      25432156,
      2635294,
      10900196,
      144159,
      14473847,
      14648404,
      21695584,
      25477204,
      5877186,
      1583346,
      2073346,
      25324697,
      25636946,
      26200715,
      5865578,
      6217415,
      1581667,
      22951363,
      23344734,
      23505514,
      25594902,
      9055547,
      10642428,
      22238176,
      23594023,
      25033618,
      26690753,
      22345134,
      25163481,
      26690289,
      7627730,
      8265722,
      11127060,
      13005844,
      14611553,
      23037654,
      25750836,
      25938844,
      26690918,
      9256534,
      21541662,
      22885018,
      22932310,
      21561084,
      23454130,
      25085026,
      25939452,
      26052657,
      26062763,
      26217029,
      276492,
      12484133,
      22795761,
      25858888,
      2817030,
      3337169,
      9545004,
      10184328,
      21598699,
      23298820,
      25051779,
      25077206,
      25110139,
      26131819,
      26644330,
      26690570,
      26690651,
      7649245,
      23917591,
      24072116,
      25339989,
      25421877,
      3959665,
      5764216,
      8595774,
      17990,
      24105474,
      25814290,
      26476138,
      2722593,
      8092876,
      23915079,
      24069387,
      25411670,
      26559080,
      621167,
      13156925,
      23265031,
      3077291,
      22720985,
      25175902,
      25203296,
      26679349,
      4612200,
      4721773,
      7123894,
      24038003,
      2499322,
      25426910,
      26626040,
      26685258,
      3146281,
      4543652,
      11063846,
      13751797,
      24437532,
      25083428,
      25430065,
      25857414,
      26446958,
      26614220,
      145206,
      25043810,
      6014210
    ]
  }
}