{
  "cmd": "STOP_LIVE_ROOM_LIST",
  "data": {
    "room_id_list": [
      25756485,
      26396920,
      26612864,
      26637376,
      8310765,
      23917362,
      26213773,
      483276,
      5279816,
      23091010,
      23218653,
      24521650,
      24816494,
      11505610,
      22912457,
      24076955,
      26689837,
      26687958,
      25928663,
      21243667,
      24104679,
      25872681,
      443365,
      704045,
      24081367,
      24228411,
      25927371,
      26531114,
      3679466,
      22216957,
      25141941,
      25522419,
      26557219,
      6889891,
      1165086,
      24228324,
      24307811,
      26052214,
      6347304,
      23511403,
      24104954,
      25004284,
      25157403,
      25727504,
      3771663,
      24647183,
      24715833,
      25425112,
      25444143,
      26052213,
      22387800,
      25620659,
      25874900,
      26492358,
      1943108,
      23225661,
      23920069,
      24749659,
      25540970,
      25824719,
      26052219,
      26078259,
      26229659,
      26679383,
      26693619,
      13721538,
      21564779,
      22152633,
      22502719,
      23726838,
      25743588,
      4659099,
      1314573,
      15151428,
      1556980,
      23604650,
      24170721,
      24228268,
      25299998,
      26395818,
      1162261,
      22358069,
      23189024,
      24159909,
      26052218,
      26658350,
      26690757,
      916888,
      21314288,
      23328617,
      24728270,
      25005430,
      25344844,
      26050793,
      26645547,
      9061384,
      1064495,
      23564636,
      24393060,
      26052220,
      26693830,
      11912440,
      22727473,
      23251881,
      23500023,
      25663485,
      2953467,
      10618609,
      21012069,
      24235262,
      26540626,
      26690495,
      2978681,
      5748871,
      10341789,
      25387402,
      26474772,
      11274730,
      23594021,
      25394344,
      25867390,
      26346577,
      26411878,
      26683707,
      21957357,
      23357667,
      24084247,
      26052217,
      26652321,
      3130267,
      3153642,
      25668383,
      9043444,
      26394314,
      2875098,
      6338720,
      22078717,
      23998869,
      26365589,
      26523849,
      705167
    ]
  }
}