{
  "cmd": "STOP_LIVE_ROOM_LIST",
  "data": {
    "room_id_list": [
      22363990,
      23448126,
      23865592,
      26409809,
      26680292,
      26690812,
      22125755,
      24785258,
      26146624,
      26598709,
      423517,
      460365,
      14801443,
      21785765,
      22897150,
      24453852,
      25082078,
      4350932,
      6214444,
      9276318,
      23263249,
      24878298,
      26166435,
      26667546,
      3206207,
      3573985,
      1114030,
      12910654,
      24680915,
      21417328,
      21500139,
      22194002,
      2344159,
      2439998,
      26311558,
      2788808,
      317598,
      3359678,
      6991057,
      24865588,
      26408248,
      26514131,
      26580788,
      26674878,
      3304134,
      23634709,
      24061993,
      24515694,
      26106772,
      26689571,
      3145914,
      6570668,
      9051448,
      952178,
      10140118,
      10239966,
      10710579,
      21103152,
      21253118,
      22787483,
      23833580,
      25503728,
      25891607,
      33298,
      4986538,
      1216421,
      24298190,
      25425397,
      26051501,
      2616930,
      26360906,
      5059289,
      22562378,
      25668406,
      26690587,
      22026693,
      22935139,
      26173580,
      3868689,
      5561827,
      26222693,
      26388624,
      26537659,
      26676009,
      5414803,
      1534179,
      24129237,
      26019583,
      26620752,
      23164677,
      23326797,
      24119230,
      24760169,
      5494924,
      721931,
      13743301,
      1943063,
      22544593,
      24706333,
      25059768,
      26273346,
      4722066,
      10255433,
      1973221,
      23876439,
      24978786,
      25521114,
      26181874,
      8128442,
      143969,
      14556425,
      14775881,
      14833043,
      23722835,
      25641963,
      26690817,
      12505277,
      1384687,
      21598699,
      22562570,
      2290012,
      23182372,
      24499076,
      25842080,
      25990222,
      6033814,
      1051961,
      1241604,
      22828257,
      25224368,
      26096371,
      26610461,
      3456204,
      22290413,
      25270230,
      26123721,
      3026971,
      4582173,
      7040421,
      1176852,
      12324292,
      21700321,
      21778248,
      22258781,
      22290546,
      23767370,
      25902051,
      26179091,
      12254410,
      13342611,
      14024831,
      23027901,
      23474537,
      23502164,
      24128837,
      24615081,
      24826421,
      25670431,
      26496072,
      4057095,
      11881642,
      25268593,
      26029468,
      26689799,
      9492454,
      23372746,
      25044625,
      25529848,
      26065856,
      26660269,
      6435592,
      22198419,
      25323622,
      26579854,
      6939638,
      7385350,
      11615827,
      1872442,
      26016760,
      26567213,
      26643393,
      26690233,
      4542629,
      1984579,
      26185882,
      26690420,
      22351851,
      25468841,
      26051290,
      26661912,
      26683479,
      288337,
      7160064,
      13426530,
      22080367,
      22328243,
      22802469,
      25092066,
      25473494,
      26667302,
      431173,
      8069587
    ]
  }
}