{
  "cmd": "STOP_LIVE_ROOM_LIST",
  "data": {
    "room_id_list": [
      25605818,
      5904353,
      22373196,
      25224831,
      26478264,
      1638919,
      23456467,
      24409045,
      24896736,
      26232691,
      26645487,
      8760100,
      1291605,
      25799615,
      26223782,
      26679759,
      878241,
      22911907,
      26288347,
      9493402,
      11683356,
      26282625,
      26691883,
      6612437,
      22799139,
      24870402,
      26588979,
      6309409,
      23208384,
      24299678,
      24630938,
      25691934,
      3386249,
      24398544,
      25014678,
      26536358,
      2958462,
      8862538,
      14810394,
      23800619,
      25482458,
      25799575,
      26389998,
      26396261,
      26645547,
      13267719,
      25785315,
      26536269,
      22625379,
      23349282,
      23512985,
      24934302,
      25698173,
      26464450,
      26651636,
      26686627,
      14419766,
      26138537,
      26617027,
      26683397,
      4625595,
      10083563,
      24031387,
      25184210,
      4972809,
      22259624,
      25397429,
      1780150,
      23974171,
      25603721,
      25919282,
      25728416,
      26475214,
      26683276,
      32003,
      22841416,
      24832425,
      26225035,
      26309921,
      12111546,
      22662996,
      23601201,
      26225452,
      26687369,
      26693823,
      916888,
      21731133,
      22958574,
      5408026,
      9281183,
      11688084,
      21564779,
      21679351,
      23659973,
      25091059,
      25831874,
      26559355,
      24871641,
      24872889,
      10141644,
      25045039,
      26596331,
      7747327,
      26404630,
      22681930,
      26670179,
      24486466,
      24619133,
      5325592,
      11007780,
      25143231,
      25564082
    ]
  }
}