{
  "cmd": "STOP_LIVE_ROOM_LIST",
  "data": {
    "room_id_list": [
      24023683,
      26641503,
      22987935,
      23134736,
      4516114,
      23744751,
      26356850,
      26601384,
      21760099,
      23794518,
      23979953,
      25322141,
      12948822,
      26009509,
      26472146,
      26687545,
      1238349,
      21764284,
      23181610,
      24831185,
      1339842,
      22984355,
      519054,
      5776908,
      22082365,
      26326335,
      2703261,
      21498790,
      25647014,
      25833834,
      26472317,
      22403913,
      24451397,
      24697612,
      25289717,
      25608101,
      25820510,
      26091727,
      26370207,
      7931442,
      10697647,
      24722840,
      627746,
      22928428,
      24067933,
      26286036,
      8086871,
      21100169,
      23152299,
      23927179,
      26693814,
      1392434,
      22459208,
      2300528,
      24214895,
      25619133,
      26693553,
      9912474,
      25614515,
      26637233,
      6756428,
      22037329,
      24718128,
      25387076,
      25992458,
      26682328,
      4215918,
      25173716,
      25906482,
      13520695,
      22430504,
      22868880,
      23620968,
      23644920,
      24880468,
      25903720,
      24291025,
      25952910,
      22051992,
      26576682,
      3905841,
      1435431,
      25904993,
      26692895,
      26159632,
      25722039,
      8364728,
      25281902,
      26480694,
      21831789,
      23304205,
      309035,
      3217277
    ]
  }
}