{
  "cmd": "STOP_LIVE_ROOM_LIST",
  "data": {
    "room_id_list": [
      1548330,
      1656986,
      21956571,
      23639535,
      26116035,
      8673564,
      23265480,
      24431497,
      10174759,
      11158164,
      21641045,
      25964252,
      26023010,
      6068645,
      14230436,
      25538349,
      25545547,
      25952233,
      4722718,
      11600180,
      23551723,
      24301115,
      24352205,
      24404443,
      25199697,
      25928568,
      26414360,
      4026622,
      4796850,
      14301847,
      21995026,
      22905078,
      25297997,
      26471251,
      26565854,
      397413,
      1148969,
      21521565,
      24765788,
      25243872,
      5131782,
      9998560,
      26497784,
      26678774,
      26683214,
      4065731,
      4533516,
      6828152,
      1828286,
      21562827,
      24413285,
      25124033,
      26391541,
      26673856,
      26690872,
      4273873,
      6732120,
      8568712,
      12301450,
      23256812,
      26025663,
      4706391,
      5782729,
      9053502,
      914153,
      23140644,
      23878331,
      25108150,
      25384082,
      26197040,
      26683914,
      5816217,
      6914219,
      7005980,
      1897102,
      22714268,
      23397900,
      24783474,
      24950163,
      25557360,
      26169776,
      26647406,
      21319465,
      22354204,
      24305855,
      26619510,
      26682078,
      6795498,
      25588383,
      26367714,
      26657680,
      26678424,
      26688325,
      26690352,
      26690799,
      24369797,
      26213206,
      26668620,
      5550471,
      1034130,
      1879032,
      25873515,
      4906595,
      838932,
      8562364,
      127597,
      23291893,
      23723945,
      23875638,
      25587599,
      25617063,
      4686384,
      22793891,
      23528179,
      25340743,
      25755206,
      26002274,
      26690847,
      930788,
      2062142,
      22280130,
      23160158,
      24428345,
      25961485,
      26267689,
      10225773,
      1346334,
      21920838,
      24164500,
      24415767,
      26273871,
      6416396,
      10228920,
      1271314,
      23022598,
      23707904,
      24277452,
      25139322,
      25930333,
      26515408,
      26556060,
      3493102,
      4545126,
      8849065,
      242537,
      25371925,
      25642969,
      25737932,
      26690822,
      23235221,
      23327579,
      23365677,
      23371161,
      385590,
      171897,
      2039997,
      2389066,
      23950200,
      24217659,
      24419267,
      24724718,
      26511571,
      26631122,
      26663074,
      26689457,
      3226794,
      4806354,
      10852583,
      21643580,
      2245249,
      22527683,
      23159149,
      24811567,
      26168447,
      26208311,
      26563405,
      26686568,
      3503406,
      6780835,
      9415287,
      23273596,
      26550387,
      26593753,
      325067,
      5918053,
      9771836,
      14035786,
      21294042,
      23261826,
      26315343,
      32432,
      8721666,
      1380351,
      21673254,
      24222429,
      26161583,
      26293875,
      26690834,
      3357403,
      71069,
      8629633,
      9083706,
      12445187,
      13074512,
      1544557,
      23113702,
      23459331,
      24936021,
      26443761,
      5113295,
      366370
    ]
  }
}