{
  "cmd": "STOP_LIVE_ROOM_LIST",
  "data": {
    "room_id_list": [
      23204617,
      23621387,
      24799156,
      1860485,
      25759857,
      26470310,
      12791627,
      21769888,
      21563980,
      22372631,
      22543933,
      26100338,
      24929063,
      25770271,
      25800031,
      22804671,
      23335326,
      22682857,
      23186310,
      26657774,
      21851532,
      23663947,
      2420167,
      21498026,
      22788266,
      22851165,
      24995038,
      3429720,
      22943283,
      25121950,
      24767391,
      25989755,
      26693136,
      1271275,
      1613049,
      24386354,
      22709048,
      6064527,
      22706958,
      24730851,
      26040560,
      26300544,
      26452292,
      14131990,
      22746968,
      26314709,
      26454564,
      8487871,
      21887652,
      26533256,
      2760571,
      13341343,
      2569694,
      71881,
      23905546,
      25214120,
      14295819,
      23541793,
      26693539,
      24756573,
      25933393,
      22858375,
      2556696,
      2739825,
      14022460,
      23960476,
      25000076,
      26583734,
      26690721,
      26691858,
      25531491,
      25588142,
      26693372
    ]
  }
}