{
  "cmd": "STOP_LIVE_ROOM_LIST",
  "data": {
    "room_id_list": [
      156079,
      26691476,
      13796453,
      23248376,
      26691172,
      21665574,
      21814714,
      23354154,
      24998157,
      81219,
      1077561,
      25444075,
      25792782,
      26606581,
      26683365,
      3516585,
      1030316,
      1512295,
      15127659,
      22192755,
      23413036,
      8027431,
      952773,
      23674532,
      24363184,
      25702878,
      26505717,
      26548179,
      13192072,
      23331741,
      3229865,
      22010413,
      24998477,
      26580213,
      5534635,
      9560813,
      14795579,
      21780682,
      22511656,
      22826624,
      22970460,
      23330493,
      24720077,
      26418583,
      4626838,
      21819159,
      23505607,
      24601283,
      7113583,
      12123924,
      1591112,
      2229228,
      22913902,
      24056788,
      380638,
      1692310,
      22802883,
      24115567,
      24928904,
      25472441,
      25510929,
      25707775,
      26223847,
      2629564,
      459259,
      97756,
      21865100,
      22270897,
      22681232,
      23819641,
      24282476,
      25267101,
      25638031,
      26688390,
      26690424,
      5637231,
      7794305,
      18866,
      21153967,
      21901284,
      22435045,
      25768723,
      2913572,
      618709,
      8515030,
      8906430,
      21244534,
      23588055,
      24123634,
      25313402,
      5512808,
      13246079,
      2381006,
      26051770,
      26625185,
      26691182,
      8582818,
      2018107,
      22328861,
      23945070,
      797803,
      9346668,
      14071630,
      25316130,
      26225291,
      26446290,
      26645390,
      380381,
      633665,
      1762903,
      21808863,
      25403972,
      25521686,
      25555634,
      25885648,
      26649567,
      4580442,
      7441370,
      9419351,
      21240247,
      24742840,
      24962828,
      25883109,
      26027978,
      26614467,
      26683731,
      3622047,
      5546264,
      23332557,
      24287624,
      26505289,
      26691221,
      10248596,
      12519713,
      13999852,
      21702864,
      22470912,
      24232595,
      24757293,
      25291155,
      25516446,
      26682654,
      6786406,
      972303,
      9807529,
      9910002,
      22176942,
      24353933,
      24620695,
      25350256,
      26066702,
      26580898,
      26689704,
      5437828,
      6167409,
      10045046,
      10427915,
      12037913,
      21141941,
      21646985,
      24032284,
      26607996,
      8516070,
      11421537,
      22481258,
      3744476,
      4738747,
      10072585,
      10649769,
      1444185,
      5342345,
      13289296,
      22531875,
      24857340,
      25266375,
      25420673,
      25451288,
      25684935,
      337800,
      6536820,
      8974163,
      22093585,
      23226576,
      25397496,
      26033475,
      26623222,
      5177557,
      8318395,
      23836139,
      23919780,
      26085702,
      26169696,
      26420865,
      26544187,
      9213525,
      10468175,
      10717043,
      21097757,
      24563848,
      24821833,
      25285361,
      25674623,
      26098728,
      5817529,
      4290971,
      5747398
    ]
  }
}