{
  "cmd": "STOP_LIVE_ROOM_LIST",
  "data": {
    "room_id_list": [
      25526267,
      26693594,
      13081769,
      26449714,
      6943249,
      2201896,
      23285940,
      25749002,
      22924926,
      24827226,
      11946932,
      21607016,
      21785733,
      26287634,
      23782867,
      25700151,
      26693839,
      10508693,
      11788093,
      22009316,
      23218384,
      2978681,
      357576,
      4859302,
      23914004,
      8701750,
      10288196,
      25030493,
      26613268,
      26629586,
      4620161,
      1709128,
      25570935,
      26390985,
      8859037,
      26577486,
      26579904,
      295469,
      10085550,
      2005976,
      22751029,
      26298248,
      23345521,
      25862491,
      2076972,
      23488560,
      26654902,
      26693378,
      23643498,
      23993741,
      22395248,
      24629613,
      25544993,
      25971107,
      26274990,
      4055214,
      2047993,
      24880050,
      2546257,
      26417440,
      26631621,
      21047026,
      22774318,
      4780540,
      9469706,
      24053266,
      24970651,
      25599337,
      25718529,
      26510492,
      3413706,
      24252664,
      25603748,
      26582019,
      25601637,
      26635865,
      3989275,
      5513707,
      9740843,
      25583758,
      1788519,
      23141658,
      25968058,
      26100013,
      26583106,
      12437687,
      25142987,
      25428533,
      26693321,
      24253534,
      25772905,
      26461947,
      26653611,
      1357129,
      23359319,
      23595721,
      26106608,
      12741154,
      14206045,
      22366287
    ]
  }
}