{
  "cmd": "STOP_LIVE_ROOM_LIST",
  "data": {
    "room_id_list": [
      26631461,
      26692185,
      23716196,
      23897818,
      25540368,
      26556512,
      10874456,
      22254731,
      4395554,
      1083062,
      24296257,
      25465974,
      4069442,
      23175392,
      23765713,
      21679130,
      23118044,
      25215845,
      26687390,
      1147042,
      1676050,
      21422653,
      26245348,
      23224943,
      24487333,
      25026687,
      495714,
      9791723,
      13586264,
      25322471,
      26612865,
      26627538,
      24949544,
      1649063,
      26680753,
      25903827,
      24868963,
      2593383,
      26640707,
      9209498,
      1578917,
      2027820,
      25960833,
      26343745,
      5776908,
      22558317,
      23775470,
      3800122,
      24411902,
      25640745,
      26598371,
      21846188,
      25757645,
      26021926,
      6448256,
      849383,
      10910718,
      13588178,
      1479148,
      25466877,
      24144566,
      9042008,
      14313778,
      14959881,
      23897188,
      24797623,
      25600418,
      26570523,
      24812418,
      26645040,
      26680017,
      11303763,
      23482918,
      24615836,
      26190815,
      26400674,
      527541,
      22398689,
      22978302,
      26600690,
      26693822,
      25872535,
      3210853,
      26214710,
      8595478
    ]
  }
}