{
  "cmd": "STOP_LIVE_ROOM_LIST",
  "data": {
    "room_id_list": [
      13506983,
      21911586,
      26179715,
      23723945,
      24360565,
      24883091,
      25165548,
      33087,
      10491179,
      14618448,
      22576815,
      26300528,
      26690587,
      23086042,
      24214866,
      26635155,
      21721338,
      23300670,
      26660223,
      26675544,
      2780655,
      6232240,
      14830258,
      3586769,
      22716336,
      25243446,
      26582207,
      21322902,
      21873313,
      23219752,
      23645527,
      26620312,
      1634399,
      23740603,
      26572879,
      3829181,
      14661034,
      1820089,
      21917846,
      25747140,
      26687454,
      26690692,
      5005390,
      10643915,
      13773045,
      21250809,
      22498927,
      22885018,
      24433717,
      25142816,
      708552,
      25680729,
      26690904,
      3639072,
      6127563,
      9709742,
      9880500,
      14396247,
      21787311,
      2843560,
      63041,
      6704085,
      883903,
      1560442,
      23722835,
      24256291,
      24400649,
      24541078,
      25490804,
      25913122,
      25948829,
      8098946,
      21101154,
      22843308,
      25062024,
      26417280,
      26606793,
      26690830,
      6597559,
      25857820,
      26160720,
      26648344,
      3881974,
      972517,
      26602574,
      819312,
      24871755,
      24886973,
      25205759,
      25873691,
      26677774,
      2812993,
      13395441,
      25792228,
      15039970,
      21881911,
      26690928,
      33381,
      6221739,
      8409156,
      8802618,
      21674471,
      23253189,
      23269601,
      26132494,
      26191144,
      26382250,
      26538591,
      26655925,
      5534141,
      5658053,
      22698187,
      25082113,
      26306532,
      4950592,
      792835,
      21030788,
      22170111,
      25673492,
      25938637,
      26390952,
      26394403,
      26636558,
      26690924,
      26690941,
      3844987,
      6193642,
      668275,
      1332510,
      22202396,
      23822591,
      25170391,
      4243866,
      6209295,
      9595302,
      12019008,
      21170467,
      22824636,
      26521613,
      26610041,
      11820456,
      25709547,
      26308885,
      26471571,
      3189124,
      5951586,
      8084560,
      8876978,
      10055323,
      22987945,
      24124632,
      24497578,
      25464407,
      26083146,
      22364434,
      22482126,
      23584580,
      25603641,
      25829783,
      26350900,
      26466088,
      26491567,
      26624843,
      26690859,
      4663206,
      5517441,
      6008648,
      7254583,
      14441233,
      22683966,
      22962531,
      23581129,
      25544925,
      26315612,
      4694170,
      5381016
    ]
  }
}