{
  "cmd": "STOP_LIVE_ROOM_LIST",
  "data": {
    "room_id_list": [
      1345538,
      1069957,
      26097107,
      5879393,
      11678433,
      21623882,
      5231221,
      25942275,
      23647043,
      11103051,
      24942627,
      26308252,
      26305598,
      621430,
      26311713,
      26602217,
      1221356,
      13931836,
      7305145,
      22825096,
      23949222,
      25811406,
      26628322,
      26693755,
      22374691,
      23662331,
      26057037,
      4991491,
      5776908,
      21475370,
      23794015,
      25838470,
      26364562,
      26372617,
      5504130,
      22834560,
      9744586,
      160722,
      22600312,
      22664532,
      26419680,
      26677708,
      23390968,
      25859846,
      26417432,
      26627128,
      26688740,
      10457352,
      22726528,
      25801658,
      26109621,
      26291452,
      26653241,
      26693762,
      14333978,
      26113387,
      26517474,
      25240019,
      4510489,
      8212289,
      25992788,
      26001212,
      26682944,
      2978491,
      22837339,
      24169720,
      25648464,
      25988751,
      178463,
      24311033,
      24453421,
      25126263,
      25332499,
      26363229,
      26533754,
      13742976,
      25704341,
      5214753,
      13319029,
      21443853,
      22702691,
      23377996,
      24687500,
      25195785,
      3758214,
      10903483,
      12388395,
      25277516,
      26642140,
      24769368,
      2627881,
      23420009,
      24117250,
      2444016,
      11096671,
      11674337,
      25876666,
      26481956,
      26604248,
      8791660
    ]
  }
}