{
  "cmd": "STOP_LIVE_ROOM_LIST",
  "data": {
    "room_id_list": [
      25863282,
      26693738,
      3065706,
      3826253,
      4004792,
      8812137,
      13626090,
      13755847,
      24052285,
      24526378,
      25315077,
      915103,
      24724681,
      26660779,
      6769668,
      22102623,
      22893454,
      24884712,
      26291999,
      26226930,
      24944632,
      26574017,
      26689637,
      1975793,
      25303690,
      26287713,
      26598371,
      2976726,
      22548458,
      1995928,
      25796584,
      25910855,
      233042,
      24168868,
      25822249,
      26642518,
      24059516,
      5370344,
      25532878,
      26526940,
      126376,
      26087746,
      26398165,
      26625082,
      3950726,
      229315,
      23227211,
      25346662,
      26686979,
      25768037,
      25921476,
      5861824,
      26634995,
      15012545,
      21701247,
      24754097,
      25619322,
      13498689,
      849638,
      23851796,
      3917520,
      25299396,
      10345882,
      25437683,
      26623107,
      2849532,
      11392283,
      26582069,
      25520277,
      26457270,
      12184339,
      23687962,
      5275420,
      7987152,
      11305232,
      26535686,
      26408721,
      11097070
    ]
  }
}