{
  "cmd": "STOP_LIVE_ROOM_LIST",
  "data": {
    "room_id_list": [
      10874486,
      14692074,
      22901821,
      23287360,
      25979102,
      25983872,
      3826971,
      23204514,
      24075531,
      25275624,
      25820485,
      25829783,
      25844333,
      26336538,
      5911201,
      21504907,
      25890234,
      4002554,
      999390,
      10346625,
      11034356,
      25242013,
      26085231,
      7395169,
      12191276,
      22828257,
      23018954,
      23076377,
      23248123,
      24066828,
      25142172,
      25464091,
      26253052,
      26573638,
      357085,
      556339,
      6199211,
      8111876,
      22951866,
      24706169,
      25064000,
      4390659,
      490403,
      868215,
      24499643,
      24764428,
      25976708,
      26067182,
      26667537,
      2754922,
      4237784,
      6119808,
      9208519,
      1083530,
      25169775,
      26049165,
      23715611,
      25003434,
      25889017,
      26151810,
      26601358,
      4423233,
      490719,
      96081,
      11635125,
      26507148,
      8164385,
      8356141,
      24399517,
      24585621,
      24996542,
      26161613,
      26222977,
      26643127,
      26690892,
      461636,
      6295229,
      759854,
      13257848,
      26038202,
      26184446,
      26254735,
      26687261,
      26688605,
      2785489,
      5777217,
      21313093,
      22640885,
      23784652,
      879243,
      23337204,
      25541805,
      25656968,
      26617712,
      23464462,
      24440748,
      24996970,
      25231091,
      26690879,
      10815897,
      24916117,
      26661547,
      2684431,
      5385851,
      22050704,
      23109186,
      23480648,
      26016259,
      26690794,
      4895463,
      7788141,
      1056637,
      1061031,
      11854171,
      23368303,
      26690768,
      3586769,
      3797130,
      4030681,
      5213662,
      8311480,
      11180362,
      12183622,
      1786342,
      22250332,
      25218233,
      26684916,
      3535081,
      25628024,
      26513621,
      26677892,
      2812525,
      809325,
      1205168,
      23637669,
      25396162,
      25722269,
      26572625,
      23978379,
      24284163,
      25449542,
      25530950,
      26460896,
      26473379,
      26634050,
      5148921,
      1424955,
      24289039,
      25189715,
      26027545,
      26366575,
      2856744,
      24266217,
      26586851,
      744286,
      1399810,
      1820085,
      23068408,
      23169989,
      24087485,
      24549055,
      24574166,
      25937010,
      26494395,
      10900715,
      13642585,
      22964817,
      23673275,
      25059774,
      25951872,
      26647313,
      6737205,
      11336419,
      22999576,
      24270765,
      25248735,
      26259991,
      26687313,
      23809412,
      25616426,
      4958047,
      26487325,
      8456983,
      21499186,
      22671840,
      23083734,
      23217037,
      23868571,
      26669815,
      26690876,
      938645,
      26628761
    ]
  }
}