{
  "cmd": "STOP_LIVE_ROOM_LIST",
  "data": {
    "room_id_list": [
      2191205,
      22745159,
      25077099,
      26234361,
      31351779,
      31376826,
      22453433,
      27535326,
      31220582,
      7491171,
      21358287,
      26780081,
      31188954,
      9370942,
      26449864,
      27208648,
      31305857,
      9716982,
      12442204,
      25642507,
      26857024,
      31375683,
      23006159,
      25541656,
      23742694,
      31097409,
      7017804,
      31188914,
      24267517,
      31064726,
      31236399,
      12342135,
      25967326,
      3104952,
      31316648,
      479142,
      21976483,
      24673808,
      304456,
      30525834,
      427466,
      861666,
      26070255,
      31297073,
      23761756,
      30963795,
      31363435,
      39618,
      30076879,
      30242008,
      30410982,
      31286425,
      31363714,
      31376825,
      23813863,
      2449691,
      24934714,
      30615697,
      31375785,
      31376424,
      24461888,
      23736047,
      24498065,
      30613708,
      23564147,
      22388978,
      27263779,
      25350513,
      27232977,
      30962056,
      31340425,
      25156556,
      31116561,
      31318977
    ]
  }
}