{
  "cmd": "STOP_LIVE_ROOM_LIST",
  "data": {
    "room_id_list": [
      11762252,
      11810028,
      24742752,
      25774460,
      25917911,
      390066,
      12184190,
      14142111,
      2390135,
      26634993,
      25650507,
      26683271,
      26683272,
      26378931,
      5230608,
      8915601,
      11924810,
      13979185,
      24994903,
      25578171,
      26669875,
      23775225,
      3307648,
      21298391,
      26681073,
      7424091,
      25633832,
      26656068,
      26677438,
      22330512,
      24120226,
      26558923,
      10402441,
      23077556,
      25653190,
      26348780,
      3717512,
      8390647,
      21997388,
      24215855,
      8317420,
      24094506,
      26693583,
      21893186,
      23764853,
      22446250,
      22817396,
      23033897,
      25022881,
      22545055,
      23553273,
      25533697,
      6093008,
      26693653,
      14962478,
      25956186,
      3130267,
      12394762,
      23005051,
      23723707,
      24003194,
      26536358,
      10550702,
      24408536,
      26125167,
      26688740,
      184786,
      22624116,
      22960850,
      23585228,
      25662607,
      30639,
      8204189,
      13066167,
      1851992,
      24095538,
      24257363,
      25579814,
      26583274,
      24864483,
      25990720,
      26008979,
      21155158,
      25551205,
      26630943,
      22773552,
      25143472,
      26303850
    ]
  }
}