{
  "cmd": "STOP_LIVE_ROOM_LIST",
  "data": {
    "room_id_list": [
      26265759,
      26564918,
      24875558,
      25309732,
      26662411,
      522987,
      5241448,
      9893211,
      13524090,
      21958119,
      22446250,
      24940536,
      26479815,
      26639196,
      6319497,
      92960,
      24422283,
      4144698,
      4409827,
      26604975,
      458072,
      26324754,
      26634384,
      24709145,
      6564627,
      24118403,
      25029560,
      26441963,
      3861706,
      22788939,
      24196211,
      2797383,
      2830969,
      25739363,
      25977960,
      796458,
      22864707,
      23278473,
      25807530,
      2615397,
      293789,
      3533378,
      26498396,
      23224943,
      26561620,
      26600464,
      26693554,
      1317045,
      25844531,
      25182857,
      4961851,
      25681657,
      26677638,
      9244654,
      1162295,
      21742903,
      24669249,
      25413362,
      25960698,
      26688475,
      24974459,
      25423611,
      10884081,
      13461372,
      23915265,
      25894621,
      26291903,
      24016476,
      2253843,
      22888076,
      23478063,
      24616730,
      26688138,
      8812922,
      24577387,
      25937106,
      26154290,
      26654830,
      24299415,
      25821429,
      13804529,
      24251785,
      26418664,
      292460,
      357576,
      75199,
      25274129,
      26539544,
      11199491,
      12214693,
      26360592,
      3674742,
      5649553
    ]
  }
}