{
  "cmd": "STOP_LIVE_ROOM_LIST",
  "data": {
    "room_id_list": [
      22857989,
      24495309,
      26288022,
      8896829,
      10646069,
      11792720,
      23418626,
      24361039,
      24460254,
      25339923,
      25890609,
      26690783,
      7630338,
      8224719,
      1640249,
      21730491,
      23877276,
      26355158,
      26661238,
      505708,
      593340,
      8173629,
      9307414,
      24745250,
      25266727,
      25586343,
      26690541,
      8760393,
      13475954,
      25327327,
      25384026,
      25484721,
      26072439,
      26159034,
      5497289,
      11020118,
      23493993,
      24473491,
      25877868,
      25984545,
      4819547,
      952885,
      9801271,
      15099192,
      2055571,
      23258102,
      26600029,
      9341149,
      25357706,
      25522771,
      26227988,
      26626045,
      6585193,
      12273606,
      21625190,
      21881387,
      2499322,
      26071534,
      26690701,
      6038325,
      6134397,
      8225502,
      21833608,
      23638998,
      25336624,
      25715017,
      26251721,
      26517421,
      26661417,
      90903,
      10114087,
      10680507,
      12247896,
      23529728,
      3352384,
      10555435,
      11003142,
      22081244,
      22311917,
      22352934,
      22562378,
      24070498,
      25863752,
      26682688,
      26690299,
      359036,
      10876221,
      23791095,
      24330804,
      24396526,
      25480793,
      2847602,
      9822097,
      10407604,
      1365604,
      23495800,
      24373077,
      26598462,
      26580825,
      26689475,
      26689799,
      812516,
      11032645,
      26466907,
      4373783,
      4490721,
      8064605,
      9755317,
      11785652,
      188023,
      22258571,
      23190920,
      23745893,
      25624424,
      26282284,
      26582953,
      3874570,
      21841012,
      24136068,
      25681633,
      8802618,
      9532427,
      22268169,
      25525163,
      26555064,
      2998067,
      9828456,
      15086508,
      22164026,
      22585806,
      23867134,
      25844577,
      25860737,
      9633843,
      21869706,
      24286611,
      26625606,
      8347076,
      10050856,
      21507192,
      22394765,
      23714529,
      24132211,
      26495302,
      14031977,
      1643619,
      22356540,
      25103046,
      25274699,
      25852833,
      36525,
      13624291,
      14433379,
      24068242,
      25991314,
      26559641,
      362324,
      772789,
      2156885,
      25929374,
      25942276,
      26259441,
      26690805,
      2880492,
      3448236,
      8627404,
      1689498,
      22679810,
      23045602,
      2332913,
      23420135,
      23480648,
      24238613,
      25419196,
      25464091,
      26385260,
      26689674,
      26690790,
      26690848,
      5413711,
      1038099,
      23268736,
      23628676,
      23954581,
      25349838,
      26013341,
      26686704,
      3405823,
      4603533,
      7396189,
      21673032,
      23581129,
      24284918,
      25491706,
      25568911,
      26684585,
      274355,
      2995812,
      3350364,
      4553493,
      8086384,
      987512,
      1441602,
      22171849,
      24988445,
      25398128,
      25683568,
      26485995,
      26689207,
      26690643,
      27078,
      21990721,
      22193982,
      24534762,
      7102723,
      26648425
    ]
  }
}