{
  "cmd": "STOP_LIVE_ROOM_LIST",
  "data": {
    "room_id_list": [
      11806907,
      24380223,
      26297206,
      26668426,
      26675281,
      26675283,
      12116077,
      23241002,
      26185600,
      26326933,
      26675474,
      26675479,
      26675484,
      26675486,
      26675489,
      26690864,
      10588602,
      25546811,
      26411653,
      26493794,
      26505169,
      26591064,
      26667727,
      26675491,
      26676106,
      26676145,
      3677306,
      8185071,
      22803611,
      23612000,
      26403189,
      26502676,
      26655357,
      26666186,
      26667609,
      26667705,
      26667793,
      22533413,
      22700509,
      24609680,
      26585949,
      26665800,
      26665878,
      26665881,
      26666188,
      8157740,
      23469468,
      24142899,
      25256071,
      26276494,
      26586733,
      26688344,
      26688346,
      26688348,
      26688349,
      26690917,
      7563884,
      21443716,
      22163093,
      26605471,
      26643393,
      26687942,
      26687948,
      26688078,
      26688079,
      26688343,
      3149464,
      9919550,
      21472999,
      26688398,
      26688691,
      26688692,
      26688694,
      10936783,
      21700321,
      21982968,
      23876451,
      26243208,
      26688689,
      26688690,
      26688918,
      26688919,
      26689566,
      6851227,
      21489673,
      22627810,
      23371463,
      24175536,
      26360295,
      26688915,
      26688916,
      26688917,
      26689607,
      6704091,
      9301032,
      1769615,
      1799799,
      26506876,
      26689602,
      26689604,
      26689605,
      26689606,
      9914048,
      10688378,
      23648186,
      26689819,
      26689822,
      26689824,
      26689825,
      26689827,
      373653,
      12292474,
      22852125,
      24811282,
      292681,
      9410288,
      12432435,
      1945798,
      24337334,
      25181720,
      25851913,
      25945878,
      26642596,
      26649297,
      1308132,
      21772163,
      24170138,
      24564748,
      25227911,
      26632341,
      10685452,
      159078,
      22722084,
      24520043,
      26554419,
      8807045,
      11760134,
      23499247,
      24475621,
      24677135,
      25569514,
      25573651,
      21761346,
      22872704,
      24097426,
      24969728,
      26218003,
      26544187,
      26616059,
      5399079,
      7882708,
      23260054,
      2388216,
      2842213,
      12838349,
      21727119,
      23735605,
      24516668,
      25175201,
      11880608,
      23953866,
      24495293,
      24811281,
      6185638,
      26326108,
      2808495,
      291892,
      9139022,
      23452210,
      24805254,
      25613964,
      25932706,
      26600271,
      24529588,
      26301735,
      23379110,
      25531045,
      26558443,
      3759490,
      443648,
      6967444,
      9893023,
      1822495,
      2099851,
      22123759,
      22960604,
      22987221,
      26103575,
      2984008,
      7658815,
      22519220,
      24418143,
      25989696,
      26046017,
      22604675,
      24529365,
      24565575,
      2466234,
      2542218,
      26643757,
      3028326,
      1432534,
      26675562,
      23026651,
      8585446
    ]
  }
}