{
  "cmd": "STOP_LIVE_ROOM_LIST",
  "data": {
    "room_id_list": [
      26569740,
      26636748,
      26665709,
      6431337,
      25601938,
      26214326,
      24268813,
      26169931,
      26404063,
      26576902,
      26602574,
      26680792,
      26687290,
      3970697,
      13381250,
      24201777,
      26097200,
      26443722,
      26498624,
      26691016,
      1135512,
      21442863,
      24811961,
      25135092,
      26362052,
      26562821,
      26580714,
      2180624,
      21975502,
      22885469,
      26691255,
      1390628,
      21526605,
      25246356,
      26512338,
      26529916,
      26531831,
      26618512,
      3105674,
      4831820,
      8728766,
      10189198,
      22125971,
      22862757,
      2569193,
      26376579,
      26568791,
      26690317,
      7446987,
      11371085,
      13587258,
      14213713,
      21355909,
      2183673,
      24170431,
      26679716,
      8646732,
      24005329,
      26329823,
      26492501,
      26676016,
      22962618,
      23748185,
      24730879,
      26555150,
      2671929,
      3735017,
      9836866,
      22184946,
      22825156,
      23712185,
      24008276,
      24071540,
      24885915,
      26080057,
      26421230,
      26675682,
      292427,
      3998220,
      11013137,
      25266375,
      26105073,
      26202993,
      8914744,
      25333788,
      26177903,
      26690927,
      7075235,
      945802,
      24700941,
      25223918,
      26281315,
      2892108,
      5273043,
      6147757,
      1228630,
      26411747,
      3249653,
      5060758,
      7749472,
      1337716,
      24508177,
      26658393,
      26683526,
      5353593,
      5411873,
      21926580,
      25486782,
      26037134,
      3072788,
      6690119,
      979521,
      2130737,
      23668387,
      23708684,
      24036545,
      25861553,
      26431704,
      26667965,
      6956576,
      171589,
      22155458,
      2245416,
      24574166,
      24771363,
      24827902,
      26113988,
      3603641,
      4775485,
      7065107,
      841758,
      25167646,
      25227571,
      25380378,
      25699965,
      2594076,
      26081328,
      6766440,
      22595644,
      22839260,
      26275899,
      26470448,
      2836621,
      5307537,
      1275626,
      21309452,
      23662162,
      25419825,
      25694398,
      25981534,
      26384947,
      26674772,
      1185216,
      25220244,
      26231874,
      26452016,
      3182683,
      6350824,
      21649097,
      23274517,
      25207020,
      26239221,
      470813,
      83208,
      11879973,
      23404403,
      23768587,
      24916117,
      24944590,
      26611054,
      26672013,
      5930086,
      26211690,
      26453093,
      4846724,
      5169698,
      7543333,
      24257535,
      25085833,
      25415019,
      25480793,
      26042056,
      26397431,
      4435586,
      4787311,
      25239943,
      7842203
    ]
  }
}