{
  "cmd": "STOP_LIVE_ROOM_LIST",
  "data": {
    "room_id_list": [
      25984820,
      14449601,
      21381766,
      24711708,
      26228632,
      26369553,
      8716483,
      9319001,
      24833730,
      26274298,
      3539771,
      2320646,
      24208947,
      25679790,
      26688312,
      26693816,
      24142935,
      24969654,
      25783748,
      269723,
      8421401,
      2023349,
      22989067,
      23933654,
      24870402,
      3837581,
      25990843,
      21755422,
      26110991,
      4916779,
      968449,
      24326636,
      24331626,
      26170612,
      26687833,
      13246865,
      21204574,
      23789862,
      23913593,
      26599868,
      26623447,
      26661055,
      26687300,
      7094431,
      12637637,
      23962433,
      24818267,
      25995250,
      26689886,
      9063807,
      12337677,
      21187,
      21751571,
      24741451,
      25904218,
      26669475,
      26688526,
      5155026,
      24222030,
      25814163,
      25920740,
      25953033,
      26002755,
      26599604,
      23933080,
      26577720,
      4094156,
      5268631,
      5552266,
      12525001,
      23993190,
      24181300,
      24292298,
      25949130,
      26677440,
      671973,
      6766995,
      13134580,
      24659010,
      26465473,
      2820940,
      7480910,
      9444040,
      24612973,
      25258336,
      25981219,
      26363901,
      26365261,
      4283692,
      23584998,
      26098076,
      26285339,
      4383682,
      25211403,
      25988064,
      26693332,
      12393465,
      25666004,
      26338782,
      4010306,
      22458283,
      24095708,
      24722083,
      21661713,
      24073369
    ]
  }
}