{
  "cmd": "STOP_LIVE_ROOM_LIST",
  "data": {
    "room_id_list": [
      25739992,
      25750836,
      26553713,
      25653984,
      26693754,
      1930084,
      24622426,
      23382784,
      24282823,
      21742272,
      8209714,
      1274798,
      23802383,
      21329148,
      25901620,
      260522,
      26498447,
      26661342,
      1383715,
      25652061,
      26164051,
      26693653,
      4594140,
      22435648,
      25539320,
      26673667,
      8812137,
      1261447,
      22585197,
      23995778,
      24452738,
      25382214,
      26036027,
      26171572,
      5943753,
      13240206,
      25582068,
      26075696,
      5637301,
      10609925,
      22281369,
      25765734,
      26656056,
      26693781,
      21103943,
      24056443,
      26589336,
      26688826,
      26456777,
      26146588,
      22242276,
      24425351,
      10419995,
      22658686,
      25217464,
      26666681,
      26167301,
      7186469,
      25859824,
      24714666,
      25778040,
      26218887,
      26357303,
      22782786,
      23612093,
      1538611,
      24680526,
      26078860,
      26412330,
      26597425,
      26648920,
      326290,
      5335040,
      10830431,
      12405216,
      13305243,
      1391725,
      26228707,
      7731387,
      9277875,
      1697859,
      25816707,
      25830082,
      13938380,
      14381744,
      26651799
    ]
  }
}