{
  "cmd": "STOP_LIVE_ROOM_LIST",
  "data": {
    "room_id_list": [
      22958705,
      24673696,
      25020845,
      26666817,
      9504141,
      1581287,
      24698296,
      26604828,
      4208116,
      5396631,
      815274,
      14991615,
      24638543,
      3691157,
      4671072,
      11649305,
      21055513,
      25359966,
      25153668,
      26647585,
      3076778,
      12000378,
      23533985,
      26420158,
      2991874,
      5946873,
      60153,
      11279650,
      1891905,
      22728239,
      2760686,
      610289,
      14192045,
      22804423,
      3868689,
      9871954,
      22431356,
      26518661,
      5414803,
      21441453,
      26690863,
      21348648,
      23965328,
      26647549,
      4164428,
      10331846,
      11897762,
      25118811,
      26510434,
      26642204,
      6471876,
      22185883,
      24654647,
      25578912,
      26690120,
      26690860,
      3602008,
      22473940,
      23646156,
      23800892,
      25921232,
      26684123,
      26690871,
      1551560,
      1707766,
      22053454,
      26583855,
      26597238,
      26688792,
      10124205,
      23480648,
      25254321,
      25293837,
      25385218,
      26355722,
      26631122,
      26662957,
      13646678,
      14887112,
      22482724,
      22800400,
      24758554,
      25839644,
      26644861,
      26685635,
      13756895,
      24061921,
      25152839,
      25396819,
      26349318,
      3060504,
      8801205,
      23839679,
      24261436,
      24841866,
      25464091,
      26069489,
      8369608,
      26660982,
      11213769,
      11830126,
      21981525,
      24194008,
      24902664,
      25753845,
      26555966,
      26690765,
      10782508,
      22337885,
      25148017,
      25446946,
      26176855,
      26433451,
      2920537,
      5261121,
      1652581,
      22727992,
      23134857,
      26140927,
      26690495,
      4355285,
      9822936,
      11464562,
      22533433,
      2332698,
      25802453,
      26660034,
      26690873,
      25227800,
      26633454,
      2781253,
      374749,
      9478927,
      24737492,
      24795311,
      25843553,
      26662991,
      26689352,
      3993303,
      797362,
      10856265,
      21253015,
      24112231,
      25376140,
      22365663,
      23255119,
      24122943,
      26062773,
      26687369,
      26690811,
      365683,
      9565823,
      10826324,
      23024421,
      24612232,
      25822573,
      6887543,
      5639153
    ]
  }
}