{
  "cmd": "STOP_LIVE_ROOM_LIST",
  "data": {
    "room_id_list": [
      3308189,
      9684951,
      23434801,
      26533049,
      22832617,
      22932838,
      24058901,
      24780712,
      25834475,
      26408467,
      10840547,
      22956313,
      26218533,
      4719646,
      129902,
      24615432,
      26693810,
      14022063,
      21963645,
      22502335,
      26298429,
      26475979,
      516630,
      5313421,
      22526104,
      23320737,
      25949261,
      26032217,
      11207572,
      22707020,
      26439385,
      26655038,
      26693813,
      26414907,
      661271,
      7391830,
      26005597,
      11182422,
      22565273,
      26219208,
      3433959,
      6806523,
      24431497,
      26693758,
      1077640,
      12692577,
      26639678,
      21586466,
      22614736,
      10962420,
      21458564,
      22751020,
      26332872,
      4301810,
      22298858,
      23274815,
      23484438,
      26066288,
      25691696,
      2901516,
      12348250,
      24841457,
      26003309,
      765084,
      10585839,
      23421734,
      23937878,
      265648,
      26675556,
      8489598,
      26608656,
      22403746,
      26130983,
      26038418,
      26375030,
      26683093,
      4171274,
      13473952,
      21988414,
      24690730,
      4769673,
      21748813,
      26390873,
      25313518,
      26233443,
      851244,
      24162664,
      25413861,
      25506527,
      26536093,
      26646012,
      21374999,
      23687962,
      23826408,
      25197908,
      24753451,
      3048419,
      8867045,
      25519596,
      3548643,
      6586504,
      8179903
    ]
  }
}