{
  "cmd": "STOP_LIVE_ROOM_LIST",
  "data": {
    "room_id_list": [
      13079109,
      23009251,
      24785524,
      25820128,
      5719754,
      12601965,
      25366378,
      23228507,
      24780485,
      25351100,
      26311623,
      25261102,
      23444917,
      26642502,
      1337367,
      26378989,
      25242670,
      5920798,
      25063027,
      25939599,
      3380703,
      576589,
      22380731,
      23809865,
      26640025,
      26664736,
      10844028,
      25225566,
      5513659,
      7500475,
      11135539,
      22859951,
      24969622,
      23278612,
      26369147,
      21672903,
      25602609,
      26094867,
      26214294,
      26690107,
      6952714,
      26636827,
      946851,
      24185540,
      25176251,
      26309921,
      26693715,
      23779611,
      4914972,
      7125367,
      8141063,
      11666787,
      25813666,
      4684043,
      23148353,
      6417233,
      24088438,
      24905027,
      25482861,
      25525451,
      26637376,
      26688740,
      717654,
      25933582,
      26061029,
      26598547,
      26693744,
      26693789,
      8690235,
      9855294,
      10957341,
      12344839,
      26364586,
      26496037,
      3380519,
      9077665,
      1671468,
      22639891,
      26529571,
      4706231,
      26693371,
      23327839,
      23545996,
      25078539
    ]
  }
}