{
  "cmd": "STOP_LIVE_ROOM_LIST",
  "data": {
    "room_id_list": [
      26197840,
      24363092,
      31277914,
      2220463,
      27875419,
      30656476,
      30805342,
      12366875,
      24046577,
      27033072,
      31010119,
      22255277,
      27671535,
      30916261,
      30927462,
      31359381,
      31376731,
      11605033,
      3627018,
      3767162,
      25515490,
      25872012,
      31372524,
      31376278,
      22782,
      24537688,
      31172388,
      22675264,
      296998,
      30312706,
      30636210,
      31143647,
      31188928,
      11271125,
      1930675,
      21879653,
      25377200,
      398346,
      8016610,
      21686479,
      26054430,
      4914870,
      31188920,
      31376708,
      31363084,
      21491004,
      31272037,
      25085770,
      26402047,
      27166206,
      6728296,
      23447207,
      24920566,
      31041208,
      23437359,
      23685749,
      23933559,
      24080864,
      25472,
      1623510,
      31231641,
      31341936,
      24489045,
      27579696,
      22119641,
      22902737,
      25454334,
      26616806,
      3943273,
      6785989,
      13247027,
      14370687,
      24064980,
      27321195,
      31376524,
      31376675,
      30236499,
      458661,
      3089845,
      31188966,
      5320249,
      23502841,
      26241350,
      31370593,
      23445280
    ]
  }
}