{
  "cmd": "STOP_LIVE_ROOM_LIST",
  "data": {
    "room_id_list": [
      1584535,
      8370727,
      11413953,
      25625613,
      26360295,
      26591909,
      26657752,
      3282243,
      173981,
      23221634,
      23696898,
      24423383,
      25123402,
      26689679,
      896537,
      2209431,
      24041802,
      25193926,
      7356136,
      24380223,
      24758089,
      24986490,
      49999,
      21314914,
      26691189,
      762272,
      9750787,
      1007420,
      1504529,
      1739114,
      22697377,
      23614485,
      23823855,
      26025390,
      26682217,
      525146,
      1283154,
      22387666,
      24418367,
      10461704,
      11443132,
      23751361,
      24670312,
      26139105,
      26216094,
      26406809,
      26685230,
      4965503,
      10310545,
      22852412,
      23538590,
      25592969,
      35935,
      471611,
      7819890,
      9728070,
      1525949,
      22040983,
      22461590,
      23243125,
      24483170,
      25488969,
      26364175,
      26691240,
      4014338,
      4778943,
      22212624,
      24292496,
      25045831,
      25185334,
      26685528,
      4379004,
      1179703,
      22600576,
      25668863,
      8700016,
      24154070,
      25174091,
      4692230,
      22923065,
      24277054,
      26038875,
      24093171,
      26309992,
      26520542,
      26649296,
      26691151,
      3438253,
      3534450,
      11650552,
      14007889,
      22352934,
      23425189,
      25350006,
      4120706,
      5971196,
      648025,
      25947768,
      26184700,
      26602574,
      10999651,
      1378699,
      22438522,
      22626041,
      25981516,
      26213472,
      26668684,
      2731808,
      23064543,
      25275326,
      25534546,
      25016918,
      257755,
      25985983,
      310138,
      22976566,
      25346268,
      26499992,
      4132488,
      438140,
      8271491,
      24409939,
      24524573,
      4076869,
      4467592,
      664408,
      26190885,
      26304946,
      4374331,
      797726,
      9553161,
      13020443,
      23070552,
      23756359,
      24723787,
      25195532,
      26134315,
      26484921,
      5749124,
      21872583,
      23579239,
      25216778,
      25434553,
      26105073,
      4931464,
      7426603,
      22817085,
      25184826,
      26173497,
      26625070,
      5478182,
      6800766,
      2178962,
      23301607,
      1288165,
      25975342,
      132343,
      25055625,
      25604270,
      23839087
    ]
  }
}